,Area_Name,Year,Sub_Group_Name,Cases_Acquitted_or_Discharged,Cases_charge_sheets_were_not_laid_but_Final_Report_submitted,Cases_Chargesheeted,Cases_Compounded_or_Withdrawn,Cases_Convicted,Cases_Declared_False_on_Account_of_Mistake_of_Fact_or_of_Law,Cases_Investigated_Chargesheets+FR_Submitted,Cases_not_Investigated_or_in_which_investigation_was_refused,Cases_Pending_Investigation_at_Year_End,Cases_Pending_Investigation_from_previous_year,Cases_Pending_Trial_at_Year_End,Cases_Pending_Trial_from_the_previous_year,Cases_Reported,Cases_Sent_for_Trial,Cases_Trials_Completed,Cases_Withdrawn_by_the_Govt,Cases_withdrawn_by_the_Govt_during_investigation,Total_Cases_for_Trial,Persons_Acquitted,Persons_against_whom_cases_Compounded_or_Withdrawn,Persons_Arrested,Persons_Chargesheeted,Persons_Convicted,Persons_in_Custody_or_on_Bail_during_Investigation_at_Year_beginning,Persons_in_Custody_or_on_Bail_during_Investigation_at_Year_end,Persons_in_Custody_or_on_Bail_during_Trial_at_Year_End,Persons_Released_or_Freed_by_Police_or_Magistrate_before_Trial_for_want_of_evidence_or_any_other_reason,Persons_Trial_Completed,Persons_under_Trial_at_Year_beginning,Total_Persons_under_Trial
0,Andaman & Nicobar Islands,2001,01. Rape,5,2,3,0,0,0,5,0,1,3,34,36,3,3,5,0,0,39,6,0,3,3,0,6,6,45,0,6,48,51
1,Andhra Pradesh,2001,01. Rape,731,22,769,35,197,74,791,3,393,390,1974,2170,871,769,928,2,0,2937,1168,13,1150,1021,246,450,545,2191,34,1414,2597,3618
2,Arunachal Pradesh,2001,01. Rape,1,2,25,0,2,0,27,0,18,12,282,260,33,25,3,0,0,285,1,0,51,31,2,25,30,347,15,3,319,350
3,Assam,2001,01. Rape,334,95,495,10,101,45,590,0,1045,863,1964,1914,817,495,435,0,0,2409,403,14,928,585,120,806,959,2331,190,523,2283,2868
4,Bihar,2001,01. Rape,406,141,685,0,155,105,826,0,488,531,3185,3061,888,685,561,0,0,3746,756,0,1400,1302,217,719,576,5963,241,973,5634,6936
5,Chandigarh,2001,01. Rape,9,0,16,0,2,2,16,0,1,1,34,29,18,16,11,0,0,45,12,0,32,31,2,0,0,59,1,14,42,73
6,Chhattisgarh,2001,01. Rape,520,15,976,1,158,11,991,1,86,130,3966,3669,959,976,678,0,0,4645,636,67,1134,1213,276,116,37,4918,0,912,4684,5897
7,Dadra & Nagar Haveli,2001,01. Rape,0,0,8,0,1,0,8,0,1,3,21,14,6,8,1,0,0,22,9,0,10,11,1,2,1,32,0,10,31,42
8,Daman & Diu,2001,01. Rape,3,0,1,0,0,0,1,0,0,1,1,3,0,1,3,0,0,4,3,0,0,1,0,1,0,1,0,3,3,4
9,Delhi,2001,01. Rape,80,65,361,0,29,1,426,0,197,243,1651,1399,381,361,109,0,0,1760,166,0,454,394,157,114,159,2597,15,323,2526,2920
10,Goa,2001,01. Rape,10,1,14,0,10,0,15,0,5,8,47,53,12,14,20,0,0,67,12,0,14,15,22,9,7,55,1,34,74,89
11,Gujarat,2001,01. Rape,150,10,288,7,26,10,298,1,24,47,1948,1843,286,288,176,0,0,2131,223,10,401,411,32,41,31,3211,0,255,3065,3476
12,Haryana,2001,01. Rape,291,6,341,1,94,54,347,0,22,25,636,681,398,341,385,0,0,1022,443,1,539,519,126,17,35,1020,2,569,1071,1590
13,Himachal Pradesh,2001,01. Rape,75,0,110,0,30,25,110,0,35,46,389,384,124,110,105,0,0,494,110,0,152,146,36,49,51,675,4,146,675,821
14,Jammu & Kashmir,2001,01. Rape,98,4,147,5,7,26,151,0,49,57,570,533,169,147,105,0,0,680,132,5,222,225,8,3,0,909,0,140,829,1054
15,Jharkhand,2001,01. Rape,236,49,404,0,99,11,453,0,185,82,1034,965,567,404,335,0,0,1369,267,15,637,885,114,345,62,1255,35,381,766,1651
16,Karnataka,2001,01. Rape,154,17,271,8,41,24,288,4,99,122,1132,1064,293,271,195,0,0,1335,280,9,361,372,48,129,94,1609,24,328,1574,1946
17,Kerala,2001,01. Rape,111,11,510,3,32,22,521,10,505,496,2190,1826,562,510,143,0,0,2336,136,6,712,673,33,546,572,2919,13,169,2421,3094
18,Lakshadweep,2001,01. Rape,0,0,1,0,0,0,1,0,0,1,1,0,0,1,0,0,0,1,0,0,0,1,0,1,0,1,0,0,0,1
19,Madhya Pradesh,2001,01. Rape,2052,188,2616,25,589,16,2804,9,261,264,6721,6771,2851,2616,2641,0,25,9387,2285,9,3212,3199,720,132,140,8829,5,3005,8644,11843
20,Maharashtra,2001,01. Rape,727,21,1289,17,125,20,1310,0,230,258,9876,9456,1302,1289,852,0,0,10745,1085,17,1886,1915,155,323,265,14394,29,1240,13736,15651
21,Manipur,2001,01. Rape,1,20,4,0,0,0,24,0,33,37,39,36,20,4,1,0,0,40,1,0,17,4,0,22,15,64,20,1,61,65
22,Meghalaya,2001,01. Rape,11,8,21,0,0,0,29,0,64,67,236,226,26,21,11,0,0,247,13,0,29,26,0,63,57,270,9,13,257,283
23,Mizoram,2001,01. Rape,10,0,51,0,32,0,51,0,14,13,96,87,52,51,42,0,0,138,12,0,64,69,44,52,47,98,0,56,85,154
24,Nagaland,2001,01. Rape,2,3,8,1,2,0,11,0,19,13,48,45,17,8,4,0,0,53,0,3,28,13,6,19,34,55,0,6,51,64
25,Odisha,2001,01. Rape,408,22,769,0,117,40,791,1,268,310,2354,2110,790,769,525,0,0,2879,417,0,887,885,96,45,44,3029,3,513,2657,3542
26,Puducherry,2001,01. Rape,0,0,8,0,0,0,8,0,4,3,16,8,9,8,0,0,0,16,0,0,13,12,0,3,4,20,0,0,8,20
27,Punjab,2001,01. Rape,171,29,239,1,81,32,268,0,75,77,235,249,298,239,252,0,0,488,240,4,459,418,133,138,163,538,16,373,497,915
28,Rajasthan,2001,01. Rape,700,7,771,13,266,320,778,0,78,127,2614,2822,1049,771,966,0,0,3593,1055,10,1147,1146,402,41,42,5012,0,1457,5333,6479
29,Sikkim,2001,01. Rape,2,0,5,0,1,0,5,0,3,0,7,5,8,5,3,0,0,10,5,0,6,5,2,1,2,3,0,7,5,10
30,Tamil Nadu,2001,01. Rape,160,18,397,3,84,30,415,11,247,280,1288,1138,423,397,244,0,0,1535,267,10,565,534,130,313,320,1693,24,397,1566,2100
31,Tripura,2001,01. Rape,38,5,63,1,13,0,68,0,67,33,129,118,102,63,51,0,0,181,59,0,139,80,17,31,40,78,50,76,74,154
32,Uttar Pradesh,2001,01. Rape,622,152,1613,15,697,215,1765,0,192,214,5616,5337,1958,1613,1319,0,0,6950,939,25,2685,2525,1032,236,281,9460,115,1971,8931,11456
33,Uttarakhand,2001,01. Rape,34,3,58,2,30,10,61,0,9,6,157,165,74,58,64,0,0,223,46,2,82,79,36,8,9,336,2,82,341,420
34,West Bengal,2001,01. Rape,517,133,717,0,45,1,850,0,777,919,5081,4926,709,717,562,0,0,5643,706,0,1027,830,54,762,815,5943,144,760,5873,6703
35,Andaman & Nicobar Islands,2002,01. Rape,2,0,3,0,1,0,3,0,0,1,34,34,2,3,3,0,0,37,2,0,6,12,1,6,0,54,0,3,45,57
36,Andhra Pradesh,2002,01. Rape,650,23,881,20,120,74,904,0,417,393,2065,1974,1002,881,770,0,0,2855,856,15,1340,1322,175,545,512,2467,51,1031,2191,3513
37,Arunachal Pradesh,2002,01. Rape,3,5,32,0,0,0,37,0,19,18,311,282,38,32,3,0,0,314,5,0,61,29,0,30,42,371,20,5,347,376
38,Assam,2002,01. Rape,247,134,624,13,99,25,758,0,1232,1045,2229,1964,970,624,346,0,0,2588,342,20,1019,720,99,959,1078,2590,180,441,2331,3051
39,Bihar,2002,01. Rape,383,128,687,0,116,114,815,0,599,488,3373,3185,1040,687,499,0,0,3872,604,0,1304,1126,157,576,425,6328,329,761,5963,7089
40,Chandigarh,2002,01. Rape,5,1,12,0,1,0,13,0,6,1,40,34,18,12,6,0,0,46,6,0,28,20,1,0,4,72,4,7,59,79
41,Chhattisgarh,2002,01. Rape,1081,4,986,140,585,21,990,5,62,86,3146,3966,992,986,1666,0,0,4952,1415,68,1214,1230,674,43,20,3997,7,2089,4924,6154
42,Dadra & Nagar Haveli,2002,01. Rape,12,0,3,0,2,0,3,0,2,1,10,21,4,3,14,0,0,24,17,0,3,3,2,1,1,16,0,19,32,35
43,Daman & Diu,2002,01. Rape,0,0,0,0,0,0,0,0,0,0,0,0,0,0,0,0,0,0,0,0,0,0,0,0,0,1,0,0,1,1
44,Delhi,2002,01. Rape,344,21,388,0,98,3,409,1,187,197,1597,1651,403,388,442,0,0,2039,479,0,546,453,112,159,234,2459,18,591,2597,3050
45,Goa,2002,01. Rape,6,2,8,0,8,0,10,0,7,5,41,47,12,8,14,0,0,55,6,0,12,13,8,7,6,54,0,14,55,68
46,Gujarat,2002,01. Rape,184,14,244,13,39,4,258,0,29,24,1956,1948,267,244,223,0,0,2192,268,25,378,371,30,31,38,3259,0,298,3211,3582
47,Haryana,2002,01. Rape,288,3,316,1,92,54,319,0,10,22,571,636,361,316,380,0,0,952,465,6,511,535,125,35,10,959,1,590,1020,1555
48,Himachal Pradesh,2002,01. Rape,86,1,112,1,22,14,113,0,45,35,392,389,137,112,108,0,0,501,145,1,204,176,25,51,63,680,16,170,675,851
49,Jammu & Kashmir,2002,01. Rape,125,14,156,3,11,23,170,0,48,49,587,570,192,156,136,0,0,726,190,2,203,202,11,0,0,908,1,201,909,1111
50,Jharkhand,2002,01. Rape,438,65,589,9,132,31,654,0,342,230,2277,2267,797,589,570,0,0,2856,969,12,873,1052,180,601,390,2238,32,1149,2347,3399
51,Karnataka,2002,01. Rape,190,9,277,1,35,6,286,4,95,99,1183,1132,292,277,225,0,0,1409,361,1,357,338,42,94,97,1543,16,403,1609,1947
52,Kerala,2002,01. Rape,141,10,445,7,29,13,455,4,532,505,2458,2190,499,445,170,0,0,2635,227,7,600,567,29,572,601,3223,4,256,2919,3486
53,Lakshadweep,2002,01. Rape,0,0,0,0,1,0,0,0,1,0,0,1,1,0,1,0,0,1,0,0,2,0,1,0,2,0,0,1,1,1
54,Madhya Pradesh,2002,01. Rape,1837,50,2804,32,548,102,2854,3,193,261,7106,6721,2891,2804,2385,2,0,9523,2742,18,3926,3978,979,140,88,9068,0,3721,8829,12807
55,Maharashtra,2002,01. Rape,1011,32,1288,16,163,17,1320,0,245,230,9974,9876,1352,1288,1174,0,0,11164,1468,17,1871,1821,210,265,310,14520,5,1678,14394,16215
56,Manipur,2002,01. Rape,0,9,7,0,0,0,16,1,30,33,46,39,14,7,0,0,0,46,0,0,18,7,0,15,22,71,4,0,64,71
57,Meghalaya,2002,01. Rape,2,7,17,1,0,0,24,0,78,64,250,236,38,17,2,0,0,253,2,1,45,32,0,57,62,299,8,2,270,302
58,Mizoram,2002,01. Rape,10,2,53,0,22,0,55,0,32,11,106,85,76,53,32,0,0,138,4,0,83,98,41,40,25,129,0,45,76,174
59,Nagaland,2002,01. Rape,0,2,14,0,7,0,16,0,20,19,55,48,17,14,7,0,0,62,0,0,20,18,14,34,33,59,3,14,55,73
60,Odisha,2002,01. Rape,368,10,633,0,105,35,643,0,281,268,2514,2354,691,633,473,0,0,2987,469,0,820,827,133,44,36,3254,1,602,3029,3856
61,Puducherry,2002,01. Rape,1,0,3,0,2,0,3,0,7,4,16,16,6,3,3,0,0,19,1,0,8,5,2,4,7,22,0,3,20,25
62,Punjab,2002,01. Rape,185,14,255,0,76,31,269,0,74,75,229,235,299,255,261,0,0,490,319,8,538,460,143,163,198,528,43,462,538,998
63,Rajasthan,2002,01. Rape,746,10,668,13,287,350,678,0,101,78,2236,2614,1051,668,1033,0,0,3282,1191,13,937,964,409,42,13,4363,2,1600,5012,5976
64,Sikkim,2002,01. Rape,4,4,3,0,4,0,7,0,2,3,2,7,6,3,8,0,0,10,2,0,2,2,1,2,2,2,0,3,3,5
65,Tamil Nadu,2002,01. Rape,324,3,471,3,121,28,474,7,271,247,1311,1288,534,471,445,0,1,1759,524,12,695,642,151,320,356,1648,17,675,1693,2335
66,Tripura,2002,01. Rape,43,12,95,1,23,0,107,0,68,67,157,129,108,95,66,0,0,224,88,1,141,97,26,40,47,60,37,114,78,175
67,Uttar Pradesh,2002,01. Rape,767,87,1282,20,708,184,1369,0,54,192,5403,5616,1415,1282,1475,0,0,6898,1202,24,2050,2093,1142,281,97,9185,141,2344,9460,11553
68,Uttarakhand,2002,01. Rape,35,3,69,0,32,12,72,0,14,9,159,157,89,69,67,0,0,226,42,0,142,116,58,9,24,352,11,100,336,452
69,West Bengal,2002,01. Rape,373,113,842,0,63,6,955,0,575,777,5487,5081,759,842,436,0,0,5923,491,0,1279,1137,79,815,868,6510,89,570,5943,7080
70,Andaman & Nicobar Islands,2003,01. Rape,3,0,1,0,3,0,1,0,1,0,29,34,2,1,6,0,0,35,3,0,6,1,3,0,5,49,0,6,54,55
71,Andhra Pradesh,2003,01. Rape,641,11,823,5,122,75,834,8,446,417,2120,2065,946,823,763,0,0,2888,881,6,1237,1198,156,512,534,2622,17,1037,2467,3665
72,Arunachal Pradesh,2003,01. Rape,0,6,29,1,0,0,35,0,15,19,339,311,31,29,0,0,0,340,0,0,35,26,0,42,35,397,16,0,371,397
73,Assam,2003,01. Rape,355,181,769,17,105,70,950,4,1303,1232,2521,2229,1095,769,460,0,0,2998,438,29,1188,882,117,1078,1130,2888,254,555,2590,3472
74,Bihar,2003,01. Rape,493,119,592,0,148,99,711,0,774,599,3324,3373,985,592,641,0,0,3965,870,0,1120,913,197,425,452,6174,180,1067,6328,7241
75,Chandigarh,2003,01. Rape,10,1,21,0,7,0,22,0,2,6,44,40,18,21,17,0,0,61,17,0,32,32,10,4,2,77,2,27,72,104
76,Chhattisgarh,2003,01. Rape,445,13,838,51,252,19,851,2,88,62,3237,3147,898,838,697,0,0,3985,662,16,1020,1006,313,27,40,4168,1,975,4153,5159
77,Dadra & Nagar Haveli,2003,01. Rape,2,1,0,0,1,1,1,0,1,2,7,10,1,0,3,0,0,10,2,0,1,0,3,1,1,15,1,5,20,20
78,Daman & Diu,2003,01. Rape,0,1,2,0,0,0,3,0,2,0,3,1,5,2,0,0,0,3,0,0,6,3,0,0,3,4,0,0,1,4
79,Delhi,2003,01. Rape,403,27,460,0,114,3,487,4,181,187,1540,1597,490,460,517,0,2,2057,429,0,624,596,147,234,253,2479,9,576,2459,3055
80,Goa,2003,01. Rape,11,2,13,1,7,0,15,0,23,7,35,41,31,13,18,0,0,54,22,1,36,18,8,6,23,41,1,30,54,72
81,Gujarat,2003,01. Rape,205,15,216,4,24,9,231,0,25,29,1939,1956,236,216,229,0,0,2172,282,4,356,362,31,38,32,3304,0,313,3259,3621
82,Haryana,2003,01. Rape,269,9,288,0,94,47,297,0,19,10,496,571,353,288,363,0,0,859,510,0,523,519,139,10,14,829,0,649,959,1478
83,Himachal Pradesh,2003,01. Rape,94,2,106,0,28,18,108,0,45,45,376,392,126,106,122,0,0,498,141,0,146,157,33,63,43,663,9,174,680,837
84,Jammu & Kashmir,2003,01. Rape,79,1,168,3,9,21,169,0,69,48,664,587,211,168,88,0,0,755,103,4,266,265,14,0,1,1052,0,117,908,1173
85,Jharkhand,2003,01. Rape,395,70,509,7,131,22,579,0,453,342,2095,2277,712,509,526,158,0,2628,354,29,759,721,189,390,407,2387,21,543,2238,2959
86,Karnataka,2003,01. Rape,248,8,268,1,39,29,276,7,104,95,1163,1183,321,268,287,0,0,1451,389,1,410,349,41,97,131,1461,27,430,1543,1892
87,Kerala,2003,01. Rape,185,6,409,3,45,24,415,7,480,532,2629,2458,394,409,230,5,0,2862,264,2,517,520,71,601,583,3406,15,335,3223,3743
88,Lakshadweep,2003,01. Rape,0,0,1,0,0,0,1,0,2,1,1,0,2,1,0,0,0,1,0,0,2,2,0,2,2,2,0,0,0,2
89,Madhya Pradesh,2003,01. Rape,2110,44,2580,54,604,90,2624,0,209,185,6754,6942,2738,2580,2714,0,0,9522,2767,65,3694,3665,780,78,107,10366,0,3547,10313,13978
90,Maharashtra,2003,01. Rape,994,34,1203,29,190,17,1237,0,259,245,9964,9974,1268,1203,1184,0,0,11177,1367,33,1856,1804,261,310,350,14663,12,1628,14520,16324
91,Manipur,2003,01. Rape,2,9,3,0,1,0,12,0,36,30,46,46,18,3,3,0,0,49,1,0,19,4,3,22,27,71,10,4,71,75
92,Meghalaya,2003,01. Rape,2,4,18,0,2,0,22,0,96,78,264,250,40,18,4,0,0,268,3,0,50,18,2,62,88,312,6,5,299,317
93,Mizoram,2003,01. Rape,4,3,69,0,18,0,72,0,14,32,153,106,54,69,22,0,0,175,9,0,70,54,112,25,41,60,0,121,127,181
94,Nagaland,2003,01. Rape,2,4,12,1,7,0,16,0,18,20,57,55,14,12,9,0,0,67,1,0,14,13,12,33,32,59,2,13,59,72
95,Odisha,2003,01. Rape,416,13,707,0,123,53,720,0,233,281,2682,2514,725,707,539,0,0,3221,561,0,839,819,152,36,56,3360,0,713,3254,4073
96,Puducherry,2003,01. Rape,0,0,3,0,1,0,3,1,5,7,18,16,2,3,1,0,0,19,0,0,1,3,1,7,5,24,0,1,22,25
97,Punjab,2003,01. Rape,210,18,273,2,108,31,291,1,131,74,182,229,380,273,318,0,0,502,334,12,574,481,158,198,256,505,35,492,528,1009
98,Rajasthan,2003,01. Rape,636,9,649,12,283,349,658,0,144,101,1954,2236,1050,649,919,0,0,2885,965,17,928,931,378,13,10,3934,0,1343,4363,5294
99,Sikkim,2003,01. Rape,2,0,8,0,1,0,8,0,4,2,7,2,10,8,3,0,0,10,0,0,7,3,1,2,6,4,0,1,2,5
100,Tamil Nadu,2003,01. Rape,340,20,477,1,115,23,497,2,303,269,1330,1309,557,477,455,0,1,1786,419,5,661,617,128,358,393,1692,9,547,1627,2244
101,Tripura,2003,01. Rape,37,16,99,0,14,0,115,0,67,68,205,157,114,99,51,0,0,256,43,0,135,100,25,47,56,92,26,68,60,160
102,Uttar Pradesh,2003,01. Rape,654,34,719,6,682,112,753,0,100,54,4780,5403,911,719,1336,0,0,6122,981,8,1211,1121,969,97,153,8348,34,1950,9185,10306
103,Uttarakhand,2003,01. Rape,43,7,86,0,32,10,93,0,18,14,170,159,107,86,75,0,0,245,63,0,154,123,71,24,29,341,26,134,352,475
104,West Bengal,2003,01. Rape,394,53,784,0,113,15,837,1,724,575,5764,5487,1002,784,507,0,0,6271,575,0,1497,1198,120,868,1107,7013,60,695,6510,7708
105,Andaman & Nicobar Islands,2004,01. Rape,4,0,4,0,0,0,4,0,7,1,29,29,10,4,4,0,0,33,4,0,11,11,0,5,5,56,0,4,49,60
106,Andhra Pradesh,2004,01. Rape,752,43,755,7,137,47,798,4,613,446,1979,2120,1016,755,889,0,0,2875,1036,19,1443,1293,211,534,651,2649,33,1247,2622,3915
107,Arunachal Pradesh,2004,01. Rape,1,8,27,0,4,0,35,0,22,15,361,339,42,27,5,0,0,366,2,0,56,42,6,35,28,431,21,8,397,439
108,Assam,2004,01. Rape,455,173,793,28,127,72,966,0,1436,1303,2704,2521,1171,793,582,0,0,3314,478,50,1233,893,138,1130,1245,3115,225,616,2888,3781
109,Bihar,2004,01. Rape,652,165,656,0,97,137,821,0,1206,774,3231,3324,1390,656,749,0,0,3980,1037,0,1157,868,139,452,559,5866,182,1176,6174,7042
110,Chandigarh,2004,01. Rape,13,2,17,0,0,1,19,0,1,2,48,44,19,17,13,0,0,61,23,0,27,20,1,2,1,73,8,24,77,97
111,Chhattisgarh,2004,01. Rape,511,11,941,441,240,26,952,1,78,88,2986,3237,969,941,751,0,0,4178,630,501,1144,1156,329,40,16,3864,12,959,4168,5324
112,Dadra & Nagar Haveli,2004,01. Rape,5,0,5,0,0,0,5,0,3,1,7,7,7,5,5,0,0,12,12,0,12,9,0,1,4,12,0,12,15,24
113,Daman & Diu,2004,01. Rape,0,0,3,0,0,0,3,0,0,2,6,3,1,3,0,0,0,6,0,0,2,5,0,3,0,9,0,0,4,9
114,Delhi,2004,01. Rape,499,20,432,0,98,73,452,3,204,181,1375,1540,551,432,597,0,0,1972,510,0,737,684,105,253,297,2548,9,615,2479,3163
115,Goa,2004,01. Rape,10,6,33,1,7,0,39,0,21,23,50,35,37,33,17,0,0,68,10,1,48,41,7,23,23,64,7,17,41,82
116,Gujarat,2004,01. Rape,232,17,307,3,40,14,324,0,26,25,1971,1939,339,307,272,0,0,2246,335,1,481,487,50,32,26,3405,0,385,3304,3791
117,Haryana,2004,01. Rape,222,5,337,0,93,41,342,0,22,19,518,496,386,337,315,0,0,833,355,0,573,569,157,14,18,886,0,512,829,1398
118,Himachal Pradesh,2004,01. Rape,81,6,133,0,26,24,139,0,35,45,402,376,153,133,107,0,0,509,136,0,187,174,28,43,53,673,3,164,663,837
119,Jammu & Kashmir,2004,01. Rape,92,11,175,4,12,20,186,0,81,69,731,664,218,175,104,0,0,839,143,4,271,269,14,1,3,1160,0,157,1052,1321
120,Jharkhand,2004,01. Rape,395,70,509,7,131,22,579,0,649,453,1913,2095,797,509,526,158,0,2446,354,29,759,721,189,407,424,2536,21,543,2387,3108
121,Karnataka,2004,01. Rape,297,5,270,5,64,14,275,4,100,104,1066,1163,291,270,361,1,2,1432,378,10,397,359,87,131,122,1345,47,465,1461,1820
122,Kerala,2004,01. Rape,260,13,390,6,56,22,403,6,529,480,2696,2629,480,390,316,1,0,3018,344,18,562,537,85,583,530,3496,78,429,3406,3943
123,Lakshadweep,2004,01. Rape,0,0,2,0,1,0,2,0,0,2,1,0,0,2,1,0,0,2,0,0,0,2,2,2,0,2,0,2,2,4
124,Madhya Pradesh,2004,01. Rape,2130,31,2815,37,669,83,2846,0,155,209,6733,6754,2875,2815,2799,0,0,9569,2763,44,4181,4235,889,107,48,10905,5,3652,10366,14601
125,Maharashtra,2004,01. Rape,1033,29,1261,17,227,23,1290,0,334,259,9948,9964,1388,1261,1260,0,0,11225,1481,23,1914,1812,290,350,430,14681,22,1771,14663,16475
126,Manipur,2004,01. Rape,2,11,2,0,0,0,13,0,54,36,46,46,31,2,2,0,0,48,5,1,29,2,0,27,39,67,15,5,71,73
127,Meghalaya,2004,01. Rape,2,6,24,0,2,0,30,0,120,96,284,264,54,24,4,0,0,288,2,0,57,26,3,88,112,333,7,5,312,338
128,Mizoram,2004,01. Rape,20,5,15,1,100,0,20,0,14,14,47,153,20,15,120,0,0,168,1,1,15,10,2,41,44,66,2,3,60,70
129,Nagaland,2004,01. Rape,0,0,29,0,40,0,29,0,7,18,46,57,18,29,40,0,0,86,9,0,20,41,35,32,11,56,0,44,59,100
130,Odisha,2004,01. Rape,550,20,679,0,116,31,699,0,273,233,2695,2682,770,679,666,0,0,3361,599,0,906,896,165,56,66,3492,0,764,3360,4256
131,Puducherry,2004,01. Rape,2,0,4,0,2,0,4,0,5,5,18,18,4,4,4,0,0,22,2,0,6,4,2,5,7,24,0,4,24,28
132,Punjab,2004,01. Rape,204,24,333,2,93,24,357,1,139,131,216,182,390,333,297,0,0,515,299,24,563,536,167,256,260,551,23,466,505,1041
133,Rajasthan,2004,01. Rape,545,9,736,15,208,324,745,0,113,144,1922,1954,1038,736,753,0,0,2690,806,22,995,997,335,10,7,3768,1,1141,3934,4931
134,Sikkim,2004,01. Rape,1,0,2,1,2,0,2,0,5,4,5,7,3,2,3,0,0,9,2,0,3,2,2,6,6,2,1,4,4,6
135,Tamil Nadu,2004,01. Rape,317,17,570,21,107,40,587,4,290,303,1455,1330,618,570,424,0,0,1900,471,8,681,727,127,393,323,1813,24,598,1692,2419
136,Tripura,2004,01. Rape,53,8,133,0,23,3,141,0,83,67,262,205,160,133,76,0,0,338,56,0,190,130,24,56,57,142,59,80,92,222
137,Uttar Pradesh,2004,01. Rape,622,75,1163,14,660,133,1238,0,126,100,4647,4780,1397,1163,1282,0,0,5943,988,3,1942,1788,1130,153,196,8015,111,2118,8348,10136
138,Uttarakhand,2004,01. Rape,30,9,90,0,41,13,99,0,21,18,189,170,115,90,71,0,0,260,42,0,226,185,49,29,41,435,29,91,341,526
139,West Bengal,2004,01. Rape,582,126,1244,0,135,7,1370,0,822,724,6291,5764,1475,1244,717,0,0,7008,805,0,1661,1566,179,1107,1147,7595,55,984,7013,8579
140,Andaman & Nicobar Islands,2005,01. Rape,3,0,8,0,1,0,8,0,3,7,33,29,4,8,4,0,0,37,7,0,8,8,2,5,5,55,0,9,56,64
141,Andhra Pradesh,2005,01. Rape,667,17,933,14,154,70,950,0,528,613,2077,1979,935,933,821,0,0,2912,1030,14,1415,1348,197,651,644,2756,74,1227,2649,3997
142,Arunachal Pradesh,2005,01. Rape,4,9,32,0,15,0,41,0,16,22,374,361,35,32,19,0,0,393,4,0,38,32,19,28,23,440,11,23,431,463
143,Assam,2005,01. Rape,367,163,867,50,170,81,1030,1,1562,1436,2984,2704,1238,867,537,0,0,3571,507,40,1406,995,167,1245,1380,3396,276,674,3115,4110
144,Bihar,2005,01. Rape,692,86,823,1,145,129,909,0,1315,1206,3216,3231,1147,823,837,0,0,4054,1017,2,1455,1113,207,559,739,5753,162,1224,5866,6979
145,Chandigarh,2005,01. Rape,10,0,20,0,4,3,20,0,11,1,54,48,33,20,14,0,0,68,20,0,43,26,7,1,13,72,5,27,73,99
146,Chhattisgarh,2005,01. Rape,603,13,919,9,338,5,932,3,119,78,2955,2986,990,919,941,0,9,3905,591,147,1107,1086,493,16,34,3719,3,1084,3864,4950
147,Dadra & Nagar Haveli,2005,01. Rape,6,0,6,0,0,0,6,0,2,3,7,7,5,6,6,0,0,13,9,0,6,8,0,4,2,11,0,9,12,20
148,Daman & Diu,2005,01. Rape,3,0,0,0,0,0,0,0,2,0,3,6,2,0,3,0,0,6,4,0,1,0,0,0,1,5,0,4,9,9
149,Delhi,2005,01. Rape,745,17,570,0,140,3,587,1,268,204,1060,1375,658,570,885,0,3,1945,1362,0,856,848,228,297,289,1806,16,1590,2548,3396
150,Goa,2005,01. Rape,13,4,18,1,7,1,22,0,18,21,47,50,20,18,20,0,0,68,19,1,34,33,7,23,22,70,2,26,64,97
151,Gujarat,2005,01. Rape,186,19,286,3,37,4,305,1,40,26,2031,1971,324,286,223,0,0,2257,313,0,501,475,47,26,52,3520,0,360,3405,3880
152,Haryana,2005,01. Rape,229,4,375,0,96,61,379,0,43,22,568,518,461,375,325,0,0,893,405,0,627,617,147,18,28,951,0,552,886,1503
153,Himachal Pradesh,2005,01. Rape,121,2,123,2,24,14,125,0,37,35,378,402,141,123,145,0,0,525,202,2,176,190,30,53,28,629,11,232,673,863
154,Jammu & Kashmir,2005,01. Rape,111,7,174,0,5,30,181,0,71,81,789,731,201,174,116,0,0,905,220,0,248,237,5,3,5,1172,9,225,1160,1397
155,Jharkhand,2005,01. Rape,411,82,595,12,117,29,677,0,696,649,1968,1913,753,595,528,0,0,2508,1380,51,732,262,155,424,589,1212,305,1535,2536,2798
156,Karnataka,2005,01. Rape,284,7,296,0,87,19,303,5,115,100,991,1066,343,296,371,0,1,1362,446,0,381,424,119,122,74,1204,5,565,1345,1769
157,Kerala,2005,01. Rape,286,10,451,4,48,22,461,0,524,529,2809,2696,478,451,334,0,0,3147,361,4,506,520,55,530,514,3596,2,416,3496,4016
158,Lakshadweep,2005,01. Rape,0,0,0,0,0,0,0,0,0,0,1,1,0,0,0,0,0,1,0,0,0,0,0,0,0,2,0,0,2,2
159,Madhya Pradesh,2005,01. Rape,2005,40,2780,117,702,68,2820,0,188,155,6689,6733,2921,2780,2707,0,0,9513,2710,253,3900,3895,888,48,52,10949,1,3598,10905,14800
160,Maharashtra,2005,01. Rape,991,28,1441,13,177,17,1469,7,386,334,10208,9948,1545,1441,1168,0,0,11389,1590,14,2227,2111,208,430,520,14980,26,1798,14681,16792
161,Manipur,2005,01. Rape,1,7,7,0,0,0,14,0,65,54,52,46,25,7,1,0,0,53,1,0,12,7,0,39,28,73,16,1,67,74
162,Meghalaya,2005,01. Rape,1,12,37,0,2,1,49,0,133,120,318,284,63,37,3,0,0,321,1,0,65,34,2,112,131,364,12,3,333,367
163,Mizoram,2005,01. Rape,5,2,33,5,15,0,35,0,16,14,55,47,37,33,20,0,0,80,2,0,36,28,72,44,52,20,0,74,66,94
164,Nagaland,2005,01. Rape,10,8,9,0,15,0,17,0,7,7,30,46,17,9,25,0,0,55,5,0,19,21,27,11,6,45,3,32,56,77
165,Odisha,2005,01. Rape,445,8,681,0,114,51,689,1,331,273,2817,2695,799,681,559,0,0,3376,519,0,838,822,156,66,81,3639,1,675,3492,4314
166,Puducherry,2005,01. Rape,1,0,6,0,3,0,6,0,5,5,20,18,6,6,4,0,0,24,1,0,10,8,3,7,9,28,0,4,24,32
167,Punjab,2005,01. Rape,171,27,328,1,71,41,355,1,140,139,301,216,398,328,242,0,0,544,272,9,553,503,120,260,237,653,73,392,551,1054
168,Rajasthan,2005,01. Rape,600,5,772,27,227,279,777,0,50,113,1840,1922,993,772,827,0,0,2694,870,30,1110,1109,320,7,8,3657,0,1190,3768,4877
169,Sikkim,2005,01. Rape,0,2,13,0,3,0,15,0,8,5,15,5,18,13,3,0,0,18,0,0,8,13,3,6,1,12,0,3,2,15
170,Tamil Nadu,2005,01. Rape,469,12,507,14,141,67,519,1,274,290,1338,1455,571,507,610,0,0,1962,608,3,744,732,212,323,314,1722,21,820,1813,2545
171,Tripura,2005,01. Rape,86,17,144,0,35,0,161,0,84,83,285,262,162,144,121,0,0,406,97,5,157,132,54,57,69,118,13,151,142,274
172,Uttar Pradesh,2005,01. Rape,631,66,1029,28,657,132,1095,0,116,126,4360,4647,1217,1029,1288,0,0,5676,948,21,1683,1666,980,196,159,7732,54,1928,8015,9681
173,Uttarakhand,2005,01. Rape,40,8,119,3,21,8,127,0,19,21,244,189,133,119,61,0,0,308,65,0,225,215,46,41,35,539,16,111,435,650
174,West Bengal,2005,01. Rape,473,75,1649,0,74,3,1724,0,781,822,7393,6291,1686,1649,547,0,0,7940,703,0,2085,1997,100,1147,1137,8789,98,803,7595,9592
175,Andaman & Nicobar Islands,2006,01. Rape,2,0,7,0,1,0,7,0,2,3,37,33,6,7,3,0,0,40,2,0,7,10,1,5,2,62,0,3,55,65
176,Andhra Pradesh,2006,01. Rape,696,18,821,4,154,79,839,0,659,528,2044,2077,1049,821,850,0,0,2898,936,21,1360,1252,226,644,685,2825,67,1162,2756,4008
177,Arunachal Pradesh,2006,01. Rape,1,5,29,1,1,0,34,0,19,16,400,374,37,29,2,0,0,403,1,1,40,29,3,23,27,464,7,4,440,469
178,Assam,2006,01. Rape,410,164,794,24,176,91,958,0,1757,1562,3168,2984,1244,794,586,0,0,3778,517,23,1290,941,203,1380,1315,3594,414,720,3396,4337
179,Bihar,2006,01. Rape,678,146,772,0,178,150,918,0,1479,1315,3132,3216,1232,772,856,0,0,3988,1117,0,1451,1111,232,739,998,5515,81,1349,5753,6864
180,Chandigarh,2006,01. Rape,8,1,20,0,9,2,21,0,7,11,57,54,19,20,17,0,0,74,10,0,27,31,11,13,7,82,2,21,72,103
181,Chhattisgarh,2006,01. Rape,478,23,994,76,235,3,1017,1,93,119,3160,2955,995,994,713,0,0,3949,637,32,1211,1208,276,34,37,3982,0,913,3719,4927
182,Dadra & Nagar Haveli,2006,01. Rape,4,0,3,0,1,0,3,0,5,2,5,7,6,3,5,0,0,10,6,0,5,3,2,2,4,6,0,8,11,14
183,Daman & Diu,2006,01. Rape,2,0,3,0,1,0,3,0,2,2,3,3,3,3,3,0,0,6,2,0,2,3,3,1,0,3,0,5,5,8
184,Delhi,2006,01. Rape,456,13,798,0,152,3,811,0,72,268,1250,1060,623,798,608,0,5,1858,403,0,778,647,209,289,397,1841,23,612,1806,2453
185,Goa,2006,01. Rape,6,7,14,0,0,0,21,0,18,18,55,47,21,14,6,0,0,61,8,0,20,20,0,22,15,82,7,8,70,90
186,Gujarat,2006,01. Rape,157,10,332,4,50,6,342,2,44,40,2152,2031,354,332,207,0,0,2363,225,6,539,551,69,52,40,3771,0,294,3520,4071
187,Haryana,2006,01. Rape,241,3,497,0,97,67,500,0,84,43,727,568,608,497,338,0,0,1065,363,0,772,749,153,28,51,1184,0,516,951,1700
188,Himachal Pradesh,2006,01. Rape,75,1,96,1,27,17,97,0,36,37,371,378,113,96,102,0,0,474,105,1,131,121,39,28,33,605,5,144,629,750
189,Jammu & Kashmir,2006,01. Rape,108,4,211,2,13,22,215,0,84,71,877,789,250,211,121,0,0,1000,162,5,301,301,15,5,1,1291,4,177,1172,1473
190,Jharkhand,2006,01. Rape,654,49,599,2,185,38,648,0,809,696,1726,1968,799,599,839,0,0,2567,741,51,943,1119,207,589,390,1332,23,948,1212,2331
191,Karnataka,2006,01. Rape,288,12,351,21,51,21,363,5,126,115,982,991,400,351,339,0,0,1342,452,3,475,435,55,74,104,1129,10,507,1204,1639
192,Kerala,2006,01. Rape,296,31,495,1,58,20,526,0,578,524,2949,2809,601,495,354,0,1,3304,395,1,666,594,80,514,585,3714,1,475,3596,4190
193,Lakshadweep,2006,01. Rape,0,0,0,0,0,0,0,0,0,0,1,1,0,0,0,0,0,1,0,0,0,0,0,0,0,2,0,0,2,2
194,Madhya Pradesh,2006,01. Rape,1877,34,2779,13,748,81,2813,0,194,188,6830,6689,2900,2779,2625,0,0,9468,2917,27,3878,3858,1139,52,69,10724,3,4056,10949,14807
195,Maharashtra,2006,01. Rape,884,29,1351,9,163,19,1380,0,487,386,10503,10208,1500,1351,1047,0,0,11559,1358,14,2162,2049,222,520,619,15435,14,1580,14980,17029
196,Manipur,2006,01. Rape,1,12,2,1,0,0,14,0,91,65,52,52,40,2,1,0,0,54,1,0,20,2,0,28,39,74,7,1,73,75
197,Meghalaya,2006,01. Rape,12,21,35,1,2,1,56,0,150,133,338,318,74,35,14,0,0,353,11,1,71,41,2,131,147,391,14,13,364,405
198,Mizoram,2006,01. Rape,6,9,69,0,68,0,78,0,10,16,50,55,72,69,74,0,0,124,6,0,77,73,74,52,56,13,0,80,20,93
199,Nagaland,2006,01. Rape,1,0,20,1,11,0,20,0,10,7,37,30,23,20,12,0,0,50,2,1,29,24,10,6,11,56,0,12,45,69
200,Odisha,2006,01. Rape,365,9,790,0,135,37,799,0,480,331,3107,2817,985,790,500,0,0,3607,489,0,1020,995,186,81,103,3959,3,675,3639,4634
201,Puducherry,2006,01. Rape,1,0,6,0,1,0,6,0,8,5,24,20,9,6,2,0,0,26,1,0,9,7,4,9,11,30,0,5,28,35
202,Punjab,2006,01. Rape,178,29,373,0,90,38,402,1,141,140,406,301,442,373,268,0,0,674,300,0,618,578,129,237,251,802,26,429,653,1231
203,Rajasthan,2006,01. Rape,499,10,740,16,262,306,750,0,79,50,1803,1840,1085,740,761,0,0,2580,761,11,1085,1083,377,8,10,3591,0,1138,3657,4740
204,Sikkim,2006,01. Rape,1,0,16,0,1,0,16,0,12,8,29,15,20,16,2,0,0,31,1,0,17,14,1,1,4,24,0,2,12,26
205,Tamil Nadu,2006,01. Rape,358,9,413,4,108,19,422,2,288,274,1281,1338,457,413,466,0,0,1751,426,1,573,546,146,314,337,1695,4,572,1722,2268
206,Tripura,2006,01. Rape,52,14,177,0,25,0,191,0,82,84,385,285,189,177,77,0,0,462,67,0,167,145,20,69,40,176,51,87,118,263
207,Uttar Pradesh,2006,01. Rape,601,89,1094,8,637,144,1183,0,103,116,4208,4360,1314,1094,1238,0,0,5454,940,14,1770,1701,999,159,163,7480,65,1939,7732,9433
208,Uttarakhand,2006,01. Rape,68,12,128,1,29,6,140,0,20,19,274,244,147,128,97,0,0,372,129,1,233,215,57,35,25,567,28,186,539,754
209,West Bengal,2006,01. Rape,747,90,1520,0,137,3,1610,1,898,781,8029,7393,1731,1520,884,0,0,8913,861,0,2045,1774,160,1137,1223,9542,185,1021,8789,10563
210,Andaman & Nicobar Islands,2007,01. Rape,2,0,3,0,1,0,3,0,2,2,37,37,3,3,3,0,0,40,4,0,3,3,1,2,2,60,0,5,62,65
211,Andhra Pradesh,2007,01. Rape,834,25,1066,3,128,86,1091,1,551,659,2145,2044,1070,1066,962,0,0,3110,1086,5,1436,1467,199,685,637,3002,17,1285,2825,4292
212,Arunachal Pradesh,2007,01. Rape,2,11,29,0,5,0,40,0,27,19,422,400,48,29,7,0,0,429,3,0,57,37,7,27,24,491,23,10,464,501
213,Assam,2007,01. Rape,466,216,904,28,191,109,1120,0,1965,1757,3387,3168,1437,904,657,0,0,4072,610,22,1477,965,180,1315,1495,3747,332,790,3594,4559
214,Bihar,2007,01. Rape,659,197,1103,1,167,317,1300,0,1417,1479,3408,3132,1555,1103,826,0,0,4235,982,1,1816,1446,212,998,1148,5766,220,1194,5515,6961
215,Chandigarh,2007,01. Rape,8,1,19,0,11,0,20,0,9,7,57,57,22,19,19,0,0,76,12,0,24,25,14,7,6,81,0,26,82,107
216,Chhattisgarh,2007,01. Rape,506,7,939,4,162,22,946,0,107,93,3427,3160,982,939,668,0,0,4099,612,51,1146,1126,238,37,54,4207,3,850,3982,5108
217,Dadra & Nagar Haveli,2007,01. Rape,2,0,6,0,0,0,6,0,6,5,9,5,7,6,2,0,0,11,2,0,5,6,0,4,3,10,0,2,6,12
218,Daman & Diu,2007,01. Rape,2,0,1,0,0,0,1,0,2,2,2,3,1,1,2,0,0,4,1,0,4,4,0,0,0,6,0,1,3,7
219,Delhi,2007,01. Rape,426,12,541,0,163,11,553,2,104,72,1202,1250,598,541,589,0,0,1791,411,0,731,657,227,397,453,1860,18,638,1841,2498
220,Goa,2007,01. Rape,5,1,15,0,1,0,16,0,22,18,64,55,20,15,6,0,0,70,7,0,25,16,1,15,24,90,0,8,82,98
221,Gujarat,2007,01. Rape,150,17,289,3,50,4,306,2,48,44,2238,2152,316,289,200,0,0,2441,251,5,503,479,59,40,60,3935,4,310,3771,4250
222,Haryana,2007,01. Rape,260,7,432,0,114,69,439,0,64,84,785,727,488,432,374,0,0,1159,415,0,607,616,180,51,42,1205,0,595,1184,1800
223,Himachal Pradesh,2007,01. Rape,69,4,105,3,14,28,109,0,58,36,390,371,159,105,83,0,0,476,102,4,197,156,19,33,67,636,7,121,605,761
224,Jammu & Kashmir,2007,01. Rape,129,10,238,0,8,34,248,0,90,84,978,877,288,238,137,0,0,1115,184,0,331,318,7,1,4,1418,10,191,1291,1609
225,Jharkhand,2007,01. Rape,535,60,692,8,318,56,752,0,856,809,1557,1726,855,692,853,0,0,2418,700,8,886,832,206,390,407,1250,37,906,1332,2164
226,Karnataka,2007,01. Rape,235,20,364,3,59,24,384,7,146,126,1049,982,436,364,294,0,1,1346,276,0,518,514,59,104,98,1308,10,335,1129,1643
227,Kerala,2007,01. Rape,448,19,546,5,74,15,565,0,510,578,2968,2949,512,546,522,0,0,3495,596,5,555,655,88,585,485,3680,0,684,3714,4369
228,Lakshadweep,2007,01. Rape,0,0,1,0,0,0,1,0,0,0,2,1,1,1,0,0,0,2,0,0,1,1,0,0,0,3,0,0,2,3
229,Madhya Pradesh,2007,01. Rape,1950,44,2898,6,688,58,2942,0,204,194,7084,6830,3010,2898,2638,0,0,9728,2595,5,4131,4132,1133,69,68,11123,0,3728,10724,14856
230,Maharashtra,2007,01. Rape,754,47,1404,10,151,16,1451,1,470,487,10992,10503,1451,1404,905,0,0,11907,1112,13,2097,2026,178,619,677,16158,13,1290,15435,17461
231,Manipur,2007,01. Rape,2,8,2,1,0,0,10,0,101,91,51,52,20,2,2,0,0,54,4,1,12,2,0,39,35,71,14,4,74,76
232,Meghalaya,2007,01. Rape,7,10,32,0,8,1,42,0,189,150,355,338,82,32,15,0,0,370,10,0,76,34,17,147,166,398,23,27,391,425
233,Mizoram,2007,01. Rape,7,2,78,0,28,0,80,0,13,10,93,50,83,78,35,0,0,128,4,0,87,95,32,56,48,72,0,36,13,108
234,Nagaland,2007,01. Rape,2,2,12,1,26,0,14,0,9,10,20,37,13,12,28,0,0,49,2,3,15,15,31,11,11,35,0,33,56,71
235,Odisha,2007,01. Rape,434,14,784,2,175,31,798,0,590,480,3280,3107,939,784,609,0,0,3891,528,0,1026,1000,181,103,123,4250,6,709,3959,4959
236,Puducherry,2007,01. Rape,3,0,9,0,4,0,9,0,8,8,26,24,9,9,7,0,0,33,3,0,14,12,8,11,13,31,0,11,30,42
237,Punjab,2007,01. Rape,199,29,392,1,76,37,421,0,202,141,522,406,519,392,275,0,0,798,351,2,709,518,121,251,385,846,57,472,802,1320
238,Rajasthan,2007,01. Rape,403,6,854,15,236,364,860,0,93,79,2003,1803,1238,854,639,0,0,2657,593,15,1201,1205,300,10,6,3888,0,893,3591,4796
239,Sikkim,2007,01. Rape,3,0,19,1,0,0,19,0,17,12,44,29,24,19,3,0,0,48,3,0,30,21,0,4,7,42,6,3,24,45
240,Tamil Nadu,2007,01. Rape,311,9,434,6,87,22,443,1,345,288,1311,1281,523,434,398,0,0,1715,467,14,615,591,131,337,351,1674,10,598,1695,2286
241,Tripura,2007,01. Rape,126,4,180,0,30,0,184,0,55,82,409,385,157,180,156,0,0,565,130,1,165,161,56,40,36,150,8,186,176,337
242,Uttar Pradesh,2007,01. Rape,542,112,1293,6,573,248,1405,0,98,103,4380,4208,1648,1293,1115,0,0,5501,923,9,2283,1980,962,163,146,7566,320,1885,7480,9460
243,Uttarakhand,2007,01. Rape,64,9,101,0,48,9,110,0,18,20,263,274,117,101,112,0,0,375,100,0,171,156,75,25,13,548,27,175,567,723
244,West Bengal,2007,01. Rape,737,97,1832,0,101,5,1929,0,1070,898,9023,8029,2106,1832,838,0,0,9861,1104,20,2409,2433,100,1223,1057,10751,142,1204,9542,11975
245,Andaman & Nicobar Islands,2008,01. Rape,5,0,2,0,0,0,2,0,12,2,34,37,12,2,5,0,0,39,6,0,13,2,0,2,13,56,0,6,60,62
246,Andhra Pradesh,2008,01. Rape,712,24,1083,4,100,83,1107,0,617,551,2412,2145,1257,1083,812,0,1,3228,1317,3,1531,1526,244,637,610,2964,32,1561,3002,4528
247,Arunachal Pradesh,2008,01. Rape,1,19,22,0,1,0,41,0,28,27,442,422,42,22,2,0,0,444,1,0,37,28,2,24,13,516,20,3,491,519
248,Assam,2008,01. Rape,494,231,988,20,94,95,1219,0,2089,1965,3767,3387,1438,988,588,0,0,4375,635,42,1445,967,201,1495,1559,3836,414,836,3747,4714
249,Bihar,2008,01. Rape,561,192,921,2,168,315,1113,0,1291,1417,3598,3408,1302,921,729,0,0,4329,918,4,1464,1323,221,1148,1200,5946,89,1139,5766,7089
250,Chandigarh,2008,01. Rape,12,1,19,0,5,2,20,0,7,9,59,57,20,19,17,0,0,76,12,0,27,26,7,6,7,88,0,19,81,107
251,Chhattisgarh,2008,01. Rape,680,9,922,68,206,9,931,11,134,107,3395,3427,978,922,886,0,0,4349,619,39,1108,1059,207,54,103,4401,0,826,4207,5266
252,Dadra & Nagar Haveli,2008,01. Rape,5,0,7,0,0,0,7,0,5,6,11,9,6,7,5,0,0,16,6,0,8,8,0,3,3,12,0,6,10,18
253,Daman & Diu,2008,01. Rape,2,1,0,0,0,0,1,0,1,2,0,2,0,0,2,0,0,2,2,0,0,0,0,0,0,4,0,2,6,6
254,Delhi,2008,01. Rape,261,8,478,0,115,14,486,1,69,104,1304,1202,466,478,376,0,0,1680,324,0,573,702,155,453,307,2083,17,479,1860,2562
255,Goa,2008,01. Rape,17,2,21,0,6,0,23,0,29,22,62,64,30,21,23,0,0,85,20,0,41,20,6,24,45,84,0,26,90,110
256,Gujarat,2008,01. Rape,165,28,328,5,48,10,356,2,54,48,2348,2238,374,328,213,0,0,2566,248,3,529,535,75,60,53,4144,1,323,3935,4470
257,Haryana,2008,01. Rape,326,6,508,0,128,92,514,0,89,64,839,785,631,508,454,0,0,1293,529,0,849,801,175,42,90,1302,0,704,1205,2006
258,Himachal Pradesh,2008,01. Rape,87,5,115,1,29,19,120,0,76,58,388,390,157,115,116,0,0,505,129,2,182,176,48,67,72,633,1,177,636,812
259,Jammu & Kashmir,2008,01. Rape,131,9,142,2,10,48,151,0,110,90,977,978,219,142,141,0,0,1120,194,5,234,236,17,4,2,1438,0,211,1418,1654
260,Jharkhand,2008,01. Rape,494,87,768,42,136,47,855,0,745,856,1653,1557,791,768,630,0,0,2325,451,44,802,761,152,407,427,1364,21,603,1250,2011
261,Karnataka,2008,01. Rape,291,17,412,4,45,32,429,7,123,146,1121,1049,446,412,336,0,1,1461,353,11,642,581,53,98,142,1472,17,406,1308,1889
262,Kerala,2008,01. Rape,247,16,467,1,38,28,483,1,566,510,3149,2968,568,467,285,0,0,3435,325,1,623,557,45,485,544,3866,7,370,3680,4237
263,Lakshadweep,2008,01. Rape,0,1,1,0,1,0,2,0,0,0,2,2,2,1,1,0,0,3,0,0,1,1,1,0,0,3,0,1,3,4
264,Madhya Pradesh,2008,01. Rape,1892,51,2791,12,839,52,2842,0,247,204,7132,7084,2937,2791,2731,0,0,9875,2888,13,3875,3847,1357,68,96,10712,0,4245,11123,14970
265,Maharashtra,2008,01. Rape,889,24,1449,13,160,23,1473,1,531,470,11379,10992,1558,1449,1049,0,0,12441,1221,13,2206,2056,219,677,796,16761,31,1440,16158,18214
266,Manipur,2008,01. Rape,0,6,6,0,0,0,12,0,127,101,57,51,38,6,0,0,0,57,0,0,19,6,0,35,34,77,14,0,71,77
267,Meghalaya,2008,01. Rape,15,5,41,0,11,0,46,0,231,189,370,355,88,41,26,0,0,396,20,1,82,57,11,166,185,423,6,31,398,455
268,Mizoram,2008,01. Rape,7,0,69,0,85,0,69,0,21,13,70,93,77,69,92,0,0,162,10,0,94,81,92,48,61,51,0,102,72,153
269,Nagaland,2008,01. Rape,2,3,18,1,13,0,21,0,7,9,22,20,19,18,15,0,0,38,3,2,27,20,15,11,9,35,9,18,35,55
270,Odisha,2008,01. Rape,486,18,883,0,159,23,901,1,778,590,3518,3280,1113,883,645,0,0,4163,667,0,1045,1065,212,123,103,4436,0,879,4250,5315
271,Puducherry,2008,01. Rape,2,0,6,0,0,0,6,0,10,8,30,26,8,6,2,0,0,32,2,0,8,9,0,13,12,38,0,2,31,40
272,Punjab,2008,01. Rape,290,44,442,2,149,55,486,0,178,202,523,522,517,442,439,0,0,964,410,4,663,589,224,385,402,797,57,634,846,1435
273,Rajasthan,2008,01. Rape,431,12,857,14,232,460,869,0,119,93,2183,2003,1355,857,663,0,0,2860,623,16,1211,1205,273,6,12,4181,0,896,3888,5093
274,Sikkim,2008,01. Rape,2,0,20,0,5,0,20,0,17,17,57,44,20,20,7,0,0,64,2,0,24,20,5,7,10,55,1,7,42,62
275,Tamil Nadu,2008,01. Rape,323,22,466,4,109,26,488,1,403,345,1341,1311,573,466,432,0,0,1777,472,1,740,583,113,351,495,1671,13,585,1674,2257
276,Tripura,2008,01. Rape,61,10,185,2,23,1,195,0,63,55,508,409,204,185,84,0,0,594,84,0,210,173,21,36,24,218,49,105,150,323
277,Uttar Pradesh,2008,01. Rape,693,117,1405,4,681,339,1522,0,108,98,4407,4380,1871,1405,1374,0,0,5785,1181,4,2825,2199,1157,146,192,7423,580,2338,7566,9765
278,Uttarakhand,2008,01. Rape,68,7,79,0,39,6,86,0,13,18,235,263,87,79,107,0,0,342,105,0,108,106,81,13,14,468,1,186,548,654
279,West Bengal,2008,01. Rape,767,177,1693,2,138,6,1870,1,1456,1070,9809,9023,2263,1693,905,0,0,10716,1351,29,1790,1664,148,1057,1099,10887,84,1499,10751,12415
280,Andaman & Nicobar Islands,2009,01. Rape,2,3,14,0,1,0,17,0,13,12,45,34,18,14,3,0,0,48,2,0,36,27,1,13,22,80,0,3,56,83
281,Andhra Pradesh,2009,01. Rape,849,26,965,4,118,84,991,0,730,617,2406,2412,1188,965,967,0,0,3377,1278,2,1487,1302,182,610,775,2804,20,1460,2964,4266
282,Arunachal Pradesh,2009,01. Rape,2,12,46,0,3,0,58,0,29,28,483,442,59,46,5,0,0,488,2,0,60,51,3,13,16,562,6,5,516,567
283,Assam,2009,01. Rape,371,248,1004,47,128,119,1252,6,2343,2089,4225,3767,1631,1004,499,0,0,4771,408,32,1644,1040,235,1559,1701,4201,462,643,3836,4876
284,Bihar,2009,01. Rape,560,170,763,2,178,169,933,0,1118,1291,3621,3598,929,763,738,0,0,4361,1031,0,1086,1043,237,1200,1144,5721,99,1268,5946,6989
285,Chandigarh,2009,01. Rape,12,1,17,0,16,1,18,0,17,7,48,59,29,17,28,0,0,76,19,0,38,25,26,7,19,68,1,45,88,113
286,Chhattisgarh,2009,01. Rape,612,10,982,1,219,23,992,0,95,134,3545,3395,976,982,831,0,0,4377,577,45,1128,1117,243,103,109,4653,5,820,4401,5518
287,Dadra & Nagar Haveli,2009,01. Rape,1,0,4,0,1,0,4,0,5,5,13,11,4,4,2,0,0,15,1,0,5,5,1,3,3,15,0,2,12,17
288,Daman & Diu,2009,01. Rape,0,1,1,0,0,0,2,0,0,1,1,0,1,1,0,0,0,1,0,0,1,1,0,0,0,5,0,0,4,5
289,Delhi,2009,01. Rape,198,22,440,0,178,8,462,2,65,69,1368,1304,469,440,376,0,1,1744,249,0,557,615,195,307,242,2254,7,444,2083,2698
290,Goa,2009,01. Rape,18,4,24,0,7,0,28,0,48,29,61,62,47,24,25,0,0,86,20,0,56,41,7,45,56,98,4,27,84,125
291,Gujarat,2009,01. Rape,150,21,377,2,33,5,398,2,82,54,2540,2348,433,377,183,0,0,2725,244,2,610,597,44,53,66,4451,0,288,4144,4741
292,Haryana,2009,01. Rape,350,8,525,0,125,70,533,0,89,89,889,839,603,525,475,0,0,1364,492,0,848,832,230,90,106,1412,0,722,1302,2134
293,Himachal Pradesh,2009,01. Rape,89,2,176,0,29,25,178,0,56,76,446,388,183,176,118,0,0,564,125,0,250,260,40,72,57,728,5,165,633,893
294,Jammu & Kashmir,2009,01. Rape,194,7,196,6,12,52,203,0,84,102,961,977,237,196,206,0,0,1173,266,12,303,301,12,2,4,1449,0,278,1438,1739
295,Jharkhand,2009,01. Rape,428,49,687,23,294,46,736,0,682,745,1595,1653,719,687,722,0,0,2340,508,12,765,764,341,427,418,1267,10,849,1364,2128
296,Karnataka,2009,01. Rape,309,37,401,10,33,15,438,7,172,123,1170,1121,509,401,342,0,0,1522,468,1,595,567,48,142,148,1522,22,516,1472,2039
297,Kerala,2009,01. Rape,283,18,615,1,53,19,633,0,482,566,3427,3149,568,615,336,0,0,3764,329,1,694,751,57,544,487,4230,0,386,3866,4617
298,Lakshadweep,2009,01. Rape,0,1,0,0,0,0,1,0,0,0,2,2,1,0,0,0,0,2,0,0,0,0,0,0,0,3,0,0,3,3
299,Madhya Pradesh,2009,01. Rape,1716,34,2951,8,562,37,2985,0,223,247,7797,7132,2998,2951,2278,0,0,10083,2536,15,4243,4221,854,96,118,11528,0,3390,10712,14933
300,Maharashtra,2009,01. Rape,771,41,1433,4,182,25,1474,0,515,531,11855,11379,1483,1433,953,0,0,12812,1136,10,2075,2076,225,796,782,17466,13,1361,16761,18837
301,Manipur,2009,01. Rape,0,7,5,0,0,0,12,0,146,127,62,57,31,5,0,0,0,62,0,0,22,7,0,34,40,84,9,0,77,84
302,Meghalaya,2009,01. Rape,16,27,67,0,7,0,94,0,249,231,414,370,112,67,23,0,0,437,18,0,110,96,7,185,189,494,10,25,423,519
303,Mizoram,2009,01. Rape,8,3,86,0,58,0,89,0,15,21,90,70,83,86,66,0,0,156,21,0,81,117,53,61,25,94,0,74,51,168
304,Nagaland,2009,01. Rape,1,2,25,0,10,0,27,0,2,7,36,22,22,25,11,0,0,47,1,0,27,29,16,9,5,47,2,17,35,64
305,Odisha,2009,01. Rape,527,8,834,0,146,28,842,1,930,778,3679,3518,1023,834,673,0,0,4352,641,0,1119,1100,183,103,122,4712,0,824,4436,5536
306,Puducherry,2009,01. Rape,2,0,8,0,4,1,8,0,2,10,32,30,1,8,6,0,0,38,2,0,1,8,4,12,4,40,1,6,38,46
307,Punjab,2009,01. Rape,307,52,440,0,158,49,492,0,148,178,498,523,511,440,465,0,0,963,429,0,681,631,234,402,411,765,41,663,797,1428
308,Rajasthan,2009,01. Rape,385,13,967,14,221,518,980,0,140,119,2530,2183,1519,967,606,0,0,3150,545,23,1388,1387,296,12,13,4704,0,841,4181,5568
309,Sikkim,2009,01. Rape,12,0,19,1,5,0,19,0,16,17,58,57,18,19,17,0,0,76,12,1,19,19,5,10,10,56,0,17,55,74
310,Tamil Nadu,2009,01. Rape,315,20,515,7,91,25,535,0,439,403,1443,1341,596,515,406,0,0,1856,439,0,776,776,111,495,482,1897,13,550,1671,2447
311,Tripura,2009,01. Rape,72,10,169,2,24,0,179,0,74,63,579,508,190,169,96,0,0,677,144,4,336,169,24,24,97,215,94,168,218,387
312,Uttar Pradesh,2009,01. Rape,730,116,1312,0,623,341,1428,0,98,108,4366,4407,1759,1312,1353,0,0,5719,1381,0,2918,2168,1187,192,168,7023,774,2568,7423,9591
313,Uttarakhand,2009,01. Rape,45,7,98,0,49,15,105,0,4,13,239,235,111,98,94,0,0,333,116,0,138,146,83,14,4,415,2,199,468,614
314,West Bengal,2009,01. Rape,731,108,1572,2,130,4,1680,0,2108,1456,10518,9809,2336,1572,861,0,0,11381,1088,38,1748,1707,132,1099,1095,11336,45,1220,10887,12594
315,Andaman & Nicobar Islands,2010,01. Rape,0,0,20,0,0,0,20,0,17,13,65,45,24,20,0,0,0,65,0,0,39,28,0,22,33,108,0,0,80,108
316,Andhra Pradesh,2010,01. Rape,890,22,1210,6,141,89,1232,3,768,730,2579,2406,1362,1210,1031,0,0,3616,1134,19,1761,1674,173,775,808,3152,54,1307,2804,4478
317,Arunachal Pradesh,2010,01. Rape,2,6,34,2,4,0,40,0,36,29,509,483,47,34,6,0,0,517,2,2,49,40,4,16,20,594,5,6,562,602
318,Assam,2010,01. Rape,431,282,1110,44,95,115,1392,32,2525,2343,4765,4225,1721,1110,526,0,0,5335,532,78,1629,1153,117,1701,1716,4627,461,649,4201,5354
319,Bihar,2010,01. Rape,646,154,533,0,227,100,687,0,1126,1118,3281,3621,795,533,873,0,0,4154,1188,0,892,816,280,1144,1126,5069,94,1468,5721,6537
320,Chandigarh,2010,01. Rape,17,1,29,0,14,6,30,0,12,17,46,48,31,29,31,0,0,77,24,0,44,38,16,19,16,66,9,40,68,106
321,Chhattisgarh,2010,01. Rape,621,18,942,2,204,16,960,0,131,95,3660,3545,1012,942,825,0,0,4487,762,2,1198,1203,270,109,92,4822,12,1032,4653,5856
322,Dadra & Nagar Haveli,2010,01. Rape,2,0,4,0,2,0,4,0,4,5,13,13,3,4,4,0,0,17,2,0,3,4,2,3,2,15,0,4,15,19
323,Daman & Diu,2010,01. Rape,0,0,1,0,0,0,1,0,0,0,2,1,1,1,0,0,0,2,0,0,1,1,0,0,0,6,0,0,5,6
324,Delhi,2010,01. Rape,266,30,449,0,141,13,479,1,78,65,1410,1368,507,449,407,0,1,1817,331,0,602,532,201,242,301,2254,11,532,2254,2786
325,Goa,2010,01. Rape,22,2,44,0,5,2,46,0,36,48,78,61,36,44,27,0,0,105,25,0,50,62,7,56,42,128,2,32,98,160
326,Gujarat,2010,01. Rape,154,25,391,2,33,3,416,1,70,82,2742,2540,408,391,187,0,0,2931,255,2,617,620,40,66,63,4774,0,295,4451,5071
327,Haryana,2010,01. Rape,343,15,590,0,113,99,605,0,105,89,1023,889,720,590,456,0,0,1479,557,0,866,853,161,106,118,1547,1,718,1412,2265
328,Himachal Pradesh,2010,01. Rape,89,3,139,1,21,25,142,0,49,56,474,446,160,139,110,0,0,585,146,1,197,204,38,57,49,747,1,184,728,932
329,Jammu & Kashmir,2010,01. Rape,140,1,177,1,3,55,178,0,96,84,994,961,245,177,143,0,0,1138,205,2,266,259,5,4,11,1496,0,210,1449,1708
330,Jharkhand,2010,01. Rape,425,69,705,17,171,60,774,0,621,682,1687,1595,773,705,596,0,0,2300,482,13,836,911,194,418,343,1489,0,676,1267,2178
331,Karnataka,2010,01. Rape,296,28,512,1,54,16,540,3,199,172,1331,1170,586,512,350,0,0,1682,497,24,771,703,82,148,166,1622,50,579,1522,2225
332,Kerala,2010,01. Rape,211,18,644,0,45,18,662,1,435,482,3815,3427,634,644,256,0,0,4071,281,0,659,779,52,487,367,4676,0,333,4230,5009
333,Lakshadweep,2010,01. Rape,0,0,0,0,0,0,0,0,0,0,2,2,0,0,0,0,0,2,0,0,0,0,0,0,0,3,0,0,3,3
334,Madhya Pradesh,2010,01. Rape,1974,36,3089,27,777,34,3125,0,199,223,8108,7797,3135,3089,2751,0,0,10886,2710,31,4387,4407,1230,118,77,11964,21,3940,11528,15935
335,Maharashtra,2010,01. Rape,902,29,1458,11,146,20,1487,1,606,515,12254,11855,1599,1458,1048,0,0,13313,1243,12,2180,2145,202,782,801,18154,16,1445,17466,19611
336,Manipur,2010,01. Rape,2,11,4,0,1,0,15,0,165,146,63,62,34,4,3,0,0,66,6,0,22,5,1,40,47,82,10,7,84,89
337,Meghalaya,2010,01. Rape,5,11,80,2,4,1,91,0,306,249,483,414,149,80,9,0,0,494,10,2,135,73,4,189,233,551,18,14,494,567
338,Mizoram,2010,01. Rape,3,0,94,0,84,0,94,0,13,15,97,90,92,94,87,0,0,184,3,0,112,125,123,25,12,93,0,126,94,219
339,Nagaland,2010,01. Rape,5,1,13,0,14,0,14,0,4,2,30,36,16,13,19,0,0,49,5,0,17,19,12,5,3,49,0,17,47,66
340,Odisha,2010,01. Rape,534,19,1126,0,132,63,1145,1,746,930,4139,3679,1025,1126,666,0,0,4805,855,0,1363,1369,188,122,116,5038,0,1043,4712,6081
341,Puducherry,2010,01. Rape,0,0,2,0,1,0,2,0,3,2,33,32,3,2,1,0,0,34,0,0,5,2,1,4,7,41,0,1,40,42
342,Punjab,2010,01. Rape,324,31,438,0,166,62,469,0,208,193,457,509,546,438,490,0,0,947,469,0,766,654,244,366,417,697,61,713,756,1410
343,Rajasthan,2010,01. Rape,454,11,972,16,202,550,983,0,178,140,2830,2530,1571,972,656,0,0,3502,663,22,1343,1355,298,13,0,5076,1,961,4704,6059
344,Sikkim,2010,01. Rape,1,0,31,0,2,0,31,0,3,16,86,58,18,31,3,0,0,89,2,0,21,30,1,10,1,83,0,3,56,86
345,Tamil Nadu,2010,01. Rape,327,38,487,1,105,35,525,0,565,439,1497,1443,686,487,432,0,0,1930,512,1,777,682,136,482,558,1930,19,648,1897,2579
346,Tripura,2010,01. Rape,84,8,185,1,28,2,193,0,117,74,651,579,238,185,112,0,0,764,180,1,320,226,32,97,148,228,43,212,215,441
347,Uttar Pradesh,2010,01. Rape,687,108,1171,0,705,272,1279,0,110,98,4145,4366,1563,1171,1392,0,0,5537,1218,0,2580,1842,1304,168,203,6343,703,2522,7023,8865
348,Uttarakhand,2010,01. Rape,53,5,104,0,58,11,109,0,5,4,232,239,121,104,111,0,0,343,118,0,171,159,86,4,16,370,0,204,415,574
349,West Bengal,2010,01. Rape,565,94,1866,15,90,14,1960,1,2444,2108,11714,10518,2311,1866,655,0,0,12384,987,27,2395,2242,128,1095,1142,12436,106,1115,11336,13578
350,Andaman & Nicobar Islands,2001,02. Kidnapping & Abduction of Women & Girls,2,1,3,0,0,0,4,0,0,2,16,15,2,3,2,0,0,18,2,0,4,5,0,9,8,25,0,2,22,27
351,Andhra Pradesh,2001,02. Kidnapping & Abduction of Women & Girls,233,23,454,28,30,206,477,45,322,285,1128,965,765,454,263,0,0,1419,717,71,965,771,82,346,459,1286,81,799,1385,2156
352,Arunachal Pradesh,2001,02. Kidnapping & Abduction of Women & Girls,5,9,34,0,4,0,43,0,19,7,233,208,55,34,9,0,0,242,5,0,60,56,5,21,17,320,8,10,274,330
353,Assam,2001,02. Kidnapping & Abduction of Women & Girls,307,361,437,29,64,115,798,2,2036,1881,1662,1625,1070,437,371,0,0,2062,501,58,1583,801,109,1735,1928,2348,589,610,2215,3016
354,Bihar,2001,02. Kidnapping & Abduction of Women & Girls,221,98,398,3,76,69,496,0,584,631,2920,2822,518,398,297,0,0,3220,614,2,988,933,191,668,572,8547,151,805,8421,9354
355,Chandigarh,2001,02. Kidnapping & Abduction of Women & Girls,11,4,19,0,1,25,23,0,12,10,58,51,50,19,12,0,0,70,18,0,43,30,1,2,6,137,9,19,126,156
356,Chhattisgarh,2001,02. Kidnapping & Abduction of Women & Girls,51,15,160,2,17,2,175,3,34,43,917,827,171,160,68,0,0,987,98,13,223,207,44,9,25,1227,0,142,1175,1382
357,Dadra & Nagar Haveli,2001,02. Kidnapping & Abduction of Women & Girls,0,3,2,0,0,0,5,0,3,6,7,5,2,2,0,0,0,7,0,0,3,2,0,1,2,11,0,0,9,11
358,Daman & Diu,2001,02. Kidnapping & Abduction of Women & Girls,2,2,0,0,0,0,2,0,1,0,2,4,3,0,2,0,0,4,5,0,2,0,0,0,0,9,2,5,14,14
359,Delhi,2001,02. Kidnapping & Abduction of Women & Girls,757,513,324,0,433,188,837,0,901,962,175,1041,964,324,1190,0,0,1365,153,0,298,328,263,113,55,221,28,416,309,637
360,Goa,2001,02. Kidnapping & Abduction of Women & Girls,17,5,1,0,5,0,6,0,5,5,20,41,6,1,22,0,0,42,30,0,8,6,8,7,6,31,3,38,63,69
361,Gujarat,2001,02. Kidnapping & Abduction of Women & Girls,251,145,628,18,25,117,773,4,123,160,4410,4076,857,628,276,0,0,4704,466,21,1063,1145,30,249,157,7739,10,496,7111,8256
362,Haryana,2001,02. Kidnapping & Abduction of Women & Girls,138,20,172,0,36,91,192,0,67,53,707,709,297,172,174,0,0,881,223,0,298,283,68,22,37,1116,0,291,1124,1407
363,Himachal Pradesh,2001,02. Kidnapping & Abduction of Women & Girls,30,7,35,0,3,68,42,0,32,37,168,166,105,35,33,0,0,201,43,0,74,55,4,17,18,339,18,47,331,386
364,Jammu & Kashmir,2001,02. Kidnapping & Abduction of Women & Girls,223,33,364,18,0,148,397,0,247,288,2121,1998,504,364,223,0,0,2362,554,61,633,618,1,31,1,4025,45,555,4023,4641
365,Jharkhand,2001,02. Kidnapping & Abduction of Women & Girls,82,54,205,0,33,32,259,0,70,82,1019,929,279,205,115,0,0,1134,140,18,318,307,111,168,150,1398,29,251,1360,1667
366,Karnataka,2001,02. Kidnapping & Abduction of Women & Girls,158,44,167,4,8,77,211,2,84,103,690,693,271,167,166,0,0,860,371,5,306,271,8,89,92,1138,32,379,1251,1522
367,Kerala,2001,02. Kidnapping & Abduction of Women & Girls,50,11,61,2,3,21,72,9,52,57,365,359,97,61,53,0,0,420,90,2,114,116,7,91,62,723,27,97,706,822
368,Lakshadweep,2001,02. Kidnapping & Abduction of Women & Girls,0,0,0,0,0,0,0,0,0,0,0,0,0,0,0,0,0,0,0,0,0,0,0,0,0,0,0,0,0,0
369,Madhya Pradesh,2001,02. Kidnapping & Abduction of Women & Girls,119,155,471,115,74,24,626,0,135,130,2767,2631,668,471,193,27,13,3075,812,49,917,882,221,58,81,5346,12,1033,5546,6428
370,Maharashtra,2001,02. Kidnapping & Abduction of Women & Girls,376,104,496,38,32,96,600,1,153,239,4912,4862,611,496,408,0,0,5358,709,53,1022,1034,43,303,234,8811,57,752,8582,9616
371,Manipur,2001,02. Kidnapping & Abduction of Women & Girls,2,92,1,0,0,0,93,0,54,85,29,30,62,1,2,0,0,31,2,0,58,1,0,39,17,74,79,2,75,76
372,Meghalaya,2001,02. Kidnapping & Abduction of Women & Girls,3,5,6,0,0,0,11,0,15,15,78,75,11,6,3,0,0,81,3,0,9,8,0,32,29,97,4,3,92,100
373,Mizoram,2001,02. Kidnapping & Abduction of Women & Girls,0,0,1,0,3,0,1,0,0,0,1,3,1,1,3,0,0,4,1,0,5,7,6,6,4,4,0,7,4,11
374,Nagaland,2001,02. Kidnapping & Abduction of Women & Girls,0,0,2,0,1,0,2,0,17,13,31,30,6,2,1,0,0,32,0,0,9,1,0,9,15,43,2,0,42,43
375,Odisha,2001,02. Kidnapping & Abduction of Women & Girls,260,29,349,0,41,55,378,0,229,228,1323,1275,434,349,301,0,0,1624,444,0,555,513,56,26,59,2092,9,500,2079,2592
376,Puducherry,2001,02. Kidnapping & Abduction of Women & Girls,0,0,1,0,1,1,1,1,1,1,9,9,3,1,1,0,0,10,0,0,1,1,1,1,1,17,0,1,17,18
377,Punjab,2001,02. Kidnapping & Abduction of Women & Girls,78,70,133,2,19,103,203,1,242,225,459,425,324,133,97,0,0,558,115,11,369,233,32,273,362,644,47,147,569,802
378,Rajasthan,2001,02. Kidnapping & Abduction of Women & Girls,510,244,630,27,187,1387,874,0,87,183,4232,4326,2165,630,697,0,0,4956,1314,93,1261,1271,450,20,7,10645,3,1764,11231,12502
379,Sikkim,2001,02. Kidnapping & Abduction of Women & Girls,0,0,0,0,0,0,0,0,2,0,0,0,2,0,0,0,0,0,0,0,0,0,0,0,0,0,0,0,0,0
380,Tamil Nadu,2001,02. Kidnapping & Abduction of Women & Girls,190,82,340,23,60,204,422,58,352,440,979,912,607,340,250,0,11,1252,535,35,808,583,123,717,633,2170,309,658,2280,2863
381,Tripura,2001,02. Kidnapping & Abduction of Women & Girls,12,4,13,0,2,0,17,0,32,14,23,24,35,13,14,0,0,37,16,0,43,21,4,27,32,179,17,20,178,199
382,Uttar Pradesh,2001,02. Kidnapping & Abduction of Women & Girls,710,694,1863,63,789,273,2557,0,559,510,6707,6406,2879,1863,1499,0,0,8269,1423,83,4295,3746,1596,677,814,14452,412,3019,13808,17554
383,Uttarakhand,2001,02. Kidnapping & Abduction of Women & Girls,44,31,82,5,38,12,113,0,18,17,284,289,126,82,82,0,0,371,69,8,153,153,42,31,15,732,16,111,698,851
384,West Bengal,2001,02. Kidnapping & Abduction of Women & Girls,209,227,889,12,18,167,1116,1,1473,2062,4296,3646,695,889,227,0,0,4535,501,13,1331,1091,29,1311,1214,5959,337,530,5411,6502
385,Andaman & Nicobar Islands,2002,02. Kidnapping & Abduction of Women & Girls,2,0,1,0,0,0,1,0,0,0,15,16,1,1,2,0,0,17,6,0,1,9,0,8,0,28,0,6,25,34
386,Andhra Pradesh,2002,02. Kidnapping & Abduction of Women & Girls,375,53,438,22,28,349,491,1,335,322,1141,1128,854,438,403,0,0,1566,642,33,962,934,84,459,430,1461,57,726,1286,2220
387,Arunachal Pradesh,2002,02. Kidnapping & Abduction of Women & Girls,0,25,23,0,0,0,48,0,9,19,256,233,38,23,0,0,0,256,0,0,57,33,0,17,26,353,15,0,320,353
388,Assam,2002,02. Kidnapping & Abduction of Women & Girls,236,329,557,31,65,108,886,2,2316,2036,1887,1662,1276,557,301,0,0,2219,416,75,1967,914,86,1928,2433,2685,548,502,2348,3262
389,Bihar,2002,02. Kidnapping & Abduction of Women & Girls,242,138,447,0,81,113,585,0,630,584,3044,2920,744,447,323,0,0,3367,671,0,1154,1092,172,581,381,8796,262,843,8547,9639
390,Chandigarh,2002,02. Kidnapping & Abduction of Women & Girls,12,6,24,0,4,20,30,0,9,12,66,58,47,24,16,0,0,82,23,0,37,29,4,6,4,139,10,27,137,166
391,Chhattisgarh,2002,02. Kidnapping & Abduction of Women & Girls,137,20,138,51,39,3,158,1,27,35,821,910,154,138,176,0,0,1048,201,3,178,193,67,25,10,1139,0,268,1217,1410
392,Dadra & Nagar Haveli,2002,02. Kidnapping & Abduction of Women & Girls,1,2,5,0,0,1,7,0,1,4,11,7,5,5,1,0,0,12,1,0,6,10,0,5,1,20,0,1,11,21
393,Daman & Diu,2002,02. Kidnapping & Abduction of Women & Girls,2,2,0,0,0,0,2,0,1,1,0,2,2,0,2,0,0,2,9,0,0,0,0,0,0,0,0,9,9,9
394,Delhi,2002,02. Kidnapping & Abduction of Women & Girls,51,300,302,0,25,155,602,36,985,901,401,175,893,302,76,0,16,477,63,0,325,312,28,55,46,442,22,91,221,533
395,Goa,2002,02. Kidnapping & Abduction of Women & Girls,5,3,3,0,0,0,6,0,4,5,18,20,5,3,5,0,0,23,5,0,9,5,0,6,9,31,1,5,31,36
396,Gujarat,2002,02. Kidnapping & Abduction of Women & Girls,246,133,554,10,38,116,687,1,126,123,4670,4410,807,554,284,0,0,4964,420,16,1007,1027,28,157,130,8302,7,448,7739,8766
397,Haryana,2002,02. Kidnapping & Abduction of Women & Girls,185,30,204,1,53,84,234,0,39,67,672,707,290,204,238,0,0,911,357,3,328,333,68,37,29,1021,3,425,1116,1449
398,Himachal Pradesh,2002,02. Kidnapping & Abduction of Women & Girls,26,6,56,0,9,57,62,0,29,32,189,168,116,56,35,0,0,224,56,0,96,74,11,18,30,346,10,67,339,413
399,Jammu & Kashmir,2002,02. Kidnapping & Abduction of Women & Girls,257,20,388,14,3,122,408,0,313,247,2235,2121,596,388,260,0,0,2509,400,12,563,545,10,1,11,4148,8,410,4025,4570
400,Jharkhand,2002,02. Kidnapping & Abduction of Women & Girls,115,23,108,3,26,29,131,0,81,63,778,814,178,108,141,0,0,922,270,54,152,156,82,146,98,957,44,352,1207,1363
401,Karnataka,2002,02. Kidnapping & Abduction of Women & Girls,117,49,156,3,5,68,205,6,105,84,721,690,300,156,122,0,0,846,276,1,336,309,9,92,94,1161,25,285,1138,1447
402,Kerala,2002,02. Kidnapping & Abduction of Women & Girls,60,8,57,3,6,25,65,5,48,52,353,365,91,57,66,0,0,422,76,4,92,79,17,62,51,705,24,93,723,802
403,Lakshadweep,2002,02. Kidnapping & Abduction of Women & Girls,0,0,0,0,0,0,0,0,0,0,0,0,0,0,0,0,0,0,0,0,0,0,0,0,0,0,0,0,0,0
404,Madhya Pradesh,2002,02. Kidnapping & Abduction of Women & Girls,353,78,532,18,96,31,610,0,133,135,2832,2767,639,532,449,0,0,3299,1028,16,1126,1163,201,81,43,5264,1,1229,5346,6509
405,Maharashtra,2002,02. Kidnapping & Abduction of Women & Girls,533,74,471,27,29,96,545,0,162,153,4794,4912,650,471,562,0,0,5383,843,94,977,879,68,234,280,8685,52,911,8811,9690
406,Manipur,2002,02. Kidnapping & Abduction of Women & Girls,0,61,1,0,1,0,62,1,73,54,29,29,82,1,1,0,0,30,0,0,62,1,1,17,28,74,50,1,74,75
407,Meghalaya,2002,02. Kidnapping & Abduction of Women & Girls,3,0,8,1,0,0,8,0,17,15,82,78,10,8,3,0,0,86,2,0,21,15,0,29,33,110,2,2,97,112
408,Mizoram,2002,02. Kidnapping & Abduction of Women & Girls,0,0,1,0,1,0,1,0,1,0,2,2,2,1,1,0,0,3,0,0,3,1,1,0,2,1,0,1,1,2
409,Nagaland,2002,02. Kidnapping & Abduction of Women & Girls,0,0,2,0,0,0,2,0,18,17,33,31,4,2,0,0,1,33,0,1,4,3,1,15,14,44,2,1,43,46
410,Odisha,2002,02. Kidnapping & Abduction of Women & Girls,276,33,306,0,39,85,339,0,237,229,1314,1323,432,306,315,0,0,1629,443,0,534,543,59,59,45,2133,5,502,2092,2635
411,Puducherry,2002,02. Kidnapping & Abduction of Women & Girls,4,0,3,0,1,1,3,1,2,1,7,9,6,3,5,0,0,12,4,0,10,5,2,1,6,16,0,6,17,22
412,Punjab,2002,02. Kidnapping & Abduction of Women & Girls,74,57,149,4,36,100,206,5,285,242,494,459,354,149,110,0,0,608,168,9,348,249,111,362,415,605,46,279,644,893
413,Rajasthan,2002,02. Kidnapping & Abduction of Women & Girls,607,207,545,39,190,1212,752,0,142,87,3941,4232,2019,545,797,0,0,4777,1703,66,1103,1091,457,7,18,9510,1,2160,10645,11736
414,Sikkim,2002,02. Kidnapping & Abduction of Women & Girls,2,1,2,0,0,0,3,0,1,2,0,0,2,2,2,0,0,2,0,0,2,0,0,0,1,0,1,0,0,0
415,Tamil Nadu,2002,02. Kidnapping & Abduction of Women & Girls,363,80,357,20,66,300,437,39,283,352,887,979,714,357,429,0,7,1336,903,23,847,845,170,633,436,1919,199,1073,2170,3015
416,Tripura,2002,02. Kidnapping & Abduction of Women & Girls,10,10,29,0,1,0,39,0,41,32,41,23,48,29,11,0,0,52,32,0,60,30,1,32,38,176,24,33,179,209
417,Uttar Pradesh,2002,02. Kidnapping & Abduction of Women & Girls,868,588,1764,34,825,281,2352,0,224,559,6744,6707,2298,1764,1693,0,0,8471,1803,82,3829,3761,1887,814,465,14441,417,3690,14452,18213
418,Uttarakhand,2002,02. Kidnapping & Abduction of Women & Girls,31,38,94,0,52,15,132,0,26,18,295,284,155,94,83,0,0,378,54,0,244,170,96,15,32,752,57,150,732,902
419,West Bengal,2002,02. Kidnapping & Abduction of Women & Girls,370,173,1073,10,71,29,1246,1,891,1473,4918,4296,694,1073,441,0,0,5369,719,18,1781,1655,105,1214,1232,6772,108,824,5959,7614
420,Andaman & Nicobar Islands,2003,02. Kidnapping & Abduction of Women & Girls,0,0,0,0,0,0,0,0,2,0,15,15,2,0,0,0,0,15,0,0,1,0,0,0,1,28,0,0,28,28
421,Andhra Pradesh,2003,02. Kidnapping & Abduction of Women & Girls,243,46,543,10,31,298,589,13,366,335,1400,1141,931,543,274,0,0,1684,552,32,878,773,85,430,445,1565,90,637,1461,2234
422,Arunachal Pradesh,2003,02. Kidnapping & Abduction of Women & Girls,0,19,23,0,1,0,42,0,18,9,278,256,51,23,1,0,0,279,0,0,50,25,0,26,28,378,23,0,353,378
423,Assam,2003,02. Kidnapping & Abduction of Women & Girls,321,454,689,63,102,284,1143,4,2236,2316,2090,1887,1351,689,423,0,0,2576,644,157,1894,1106,141,2433,2452,2849,769,785,2685,3791
424,Bihar,2003,02. Kidnapping & Abduction of Women & Girls,255,124,420,5,77,76,544,0,684,630,3120,3044,674,420,332,7,0,3457,682,10,877,781,141,381,315,8744,162,823,8796,9577
425,Chandigarh,2003,02. Kidnapping & Abduction of Women & Girls,9,3,10,0,2,16,13,0,8,9,65,66,28,10,11,0,0,76,36,0,22,18,8,4,4,113,4,44,139,157
426,Chhattisgarh,2003,02. Kidnapping & Abduction of Women & Girls,62,18,105,111,25,5,123,1,44,24,727,820,149,105,87,0,0,925,83,52,135,143,37,10,2,1125,0,120,1154,1297
427,Dadra & Nagar Haveli,2003,02. Kidnapping & Abduction of Women & Girls,4,0,2,0,1,0,2,0,3,1,8,11,4,2,5,0,0,13,10,0,6,7,2,1,0,15,0,12,20,27
428,Daman & Diu,2003,02. Kidnapping & Abduction of Women & Girls,0,2,0,0,0,0,2,0,0,1,1,1,1,0,0,0,0,1,0,0,1,0,0,0,0,1,1,0,1,1
429,Delhi,2003,02. Kidnapping & Abduction of Women & Girls,118,326,201,0,14,216,527,36,1000,985,470,401,797,201,132,0,3,602,121,0,274,126,17,46,156,430,38,138,442,568
430,Goa,2003,02. Kidnapping & Abduction of Women & Girls,2,4,7,0,0,0,11,0,6,4,23,18,13,7,2,0,0,25,4,0,12,12,0,9,4,39,5,4,31,43
431,Gujarat,2003,02. Kidnapping & Abduction of Women & Girls,388,181,535,9,31,156,716,1,112,126,4777,4670,859,535,419,0,0,5205,536,12,945,917,44,130,147,8627,11,580,8302,9219
432,Haryana,2003,02. Kidnapping & Abduction of Women & Girls,189,23,159,1,50,78,182,0,50,39,591,672,271,159,239,0,0,831,317,3,354,353,67,29,28,987,2,384,1021,1374
433,Himachal Pradesh,2003,02. Kidnapping & Abduction of Women & Girls,48,7,38,1,7,49,45,0,31,29,171,189,96,38,55,0,0,227,73,1,76,82,8,30,11,346,13,81,346,428
434,Jammu & Kashmir,2003,02. Kidnapping & Abduction of Women & Girls,151,21,480,5,2,131,501,0,296,313,2557,2235,615,480,153,0,0,2715,233,11,696,700,2,11,4,4602,3,235,4148,4848
435,Jharkhand,2003,02. Kidnapping & Abduction of Women & Girls,130,39,163,8,36,27,202,0,114,81,767,778,262,163,166,0,0,941,73,29,336,266,67,98,145,1054,23,140,957,1223
436,Karnataka,2003,02. Kidnapping & Abduction of Women & Girls,148,54,152,4,1,59,206,4,80,105,720,721,244,152,149,0,0,873,272,1,242,263,2,94,40,1149,33,274,1161,1424
437,Kerala,2003,02. Kidnapping & Abduction of Women & Girls,29,3,55,3,4,9,58,7,76,48,372,353,102,55,33,0,0,408,53,5,104,89,17,51,66,719,0,70,705,794
438,Lakshadweep,2003,02. Kidnapping & Abduction of Women & Girls,0,0,0,0,0,0,0,0,0,0,0,0,0,0,0,0,0,0,0,0,0,0,0,0,0,0,0,0,0,0
439,Madhya Pradesh,2003,02. Kidnapping & Abduction of Women & Girls,635,90,484,12,158,30,574,0,121,117,2671,2992,608,484,793,0,0,3476,1020,43,918,924,265,40,32,5147,2,1285,5551,6475
440,Maharashtra,2003,02. Kidnapping & Abduction of Women & Girls,377,99,445,21,28,49,544,0,194,162,4813,4794,626,445,405,0,1,5239,657,25,938,837,61,280,328,8779,53,718,8685,9522
441,Manipur,2003,02. Kidnapping & Abduction of Women & Girls,1,47,2,0,1,0,49,0,95,73,29,29,71,2,2,0,0,31,2,0,67,2,0,28,45,74,48,2,74,76
442,Meghalaya,2003,02. Kidnapping & Abduction of Women & Girls,3,3,1,0,0,0,4,0,23,17,80,82,10,1,3,0,0,83,3,0,4,0,0,33,35,107,2,3,110,110
443,Mizoram,2003,02. Kidnapping & Abduction of Women & Girls,0,1,1,0,2,0,2,0,1,1,1,2,2,1,2,0,0,3,0,0,3,3,1,0,0,3,0,1,1,4
444,Nagaland,2003,02. Kidnapping & Abduction of Women & Girls,0,1,0,0,2,0,1,0,20,18,31,33,3,0,2,0,0,33,0,0,6,2,2,14,18,44,0,2,44,46
445,Odisha,2003,02. Kidnapping & Abduction of Women & Girls,256,45,349,0,52,70,394,0,146,237,1355,1314,373,349,308,0,0,1663,449,0,531,490,57,45,84,2117,2,506,2133,2623
446,Puducherry,2003,02. Kidnapping & Abduction of Women & Girls,2,0,3,0,0,1,3,1,10,2,8,7,13,3,2,0,0,10,5,0,13,3,0,6,16,14,0,5,16,19
447,Punjab,2003,02. Kidnapping & Abduction of Women & Girls,73,102,164,6,25,156,266,4,154,285,554,494,295,164,98,0,0,658,113,1,253,244,46,415,372,689,52,159,605,849
448,Rajasthan,2003,02. Kidnapping & Abduction of Women & Girls,556,191,495,33,188,1049,686,0,157,142,3659,3941,1750,495,744,0,0,4436,1336,62,921,925,394,18,12,8643,2,1730,9510,10435
449,Sikkim,2003,02. Kidnapping & Abduction of Women & Girls,0,0,1,0,1,0,1,0,0,1,0,0,0,1,1,0,0,1,0,0,0,0,0,1,1,0,0,0,0,0
450,Tamil Nadu,2003,02. Kidnapping & Abduction of Women & Girls,262,87,296,3,37,207,383,11,312,285,755,761,632,296,299,0,4,1057,582,4,856,677,82,436,507,1928,108,664,1919,2596
451,Tripura,2003,02. Kidnapping & Abduction of Women & Girls,14,23,46,0,10,0,69,0,1,41,63,41,29,46,24,0,0,87,21,0,68,47,6,38,43,196,16,27,176,223
452,Uttar Pradesh,2003,02. Kidnapping & Abduction of Women & Girls,594,214,1025,37,631,168,1239,2,314,224,6507,6744,1499,1025,1225,0,0,7769,1340,69,2374,2309,1513,465,487,13828,43,2853,14441,16750
453,Uttarakhand,2003,02. Kidnapping & Abduction of Women & Girls,21,37,79,2,20,16,116,0,28,26,331,295,134,79,41,0,0,374,37,1,217,179,40,32,30,853,40,77,752,931
454,West Bengal,2003,02. Kidnapping & Abduction of Women & Girls,293,88,594,16,66,62,682,0,948,891,5137,4918,801,594,359,0,0,5512,799,21,1571,1309,108,1232,1211,7153,283,907,6772,8081
455,Andaman & Nicobar Islands,2004,02. Kidnapping & Abduction of Women & Girls,1,1,3,0,1,0,4,0,1,2,16,15,3,3,2,0,0,18,1,0,2,3,5,1,0,25,0,6,28,31
456,Andhra Pradesh,2004,02. Kidnapping & Abduction of Women & Girls,421,57,508,30,50,299,565,19,513,366,1407,1400,1030,508,471,0,0,1908,715,33,1105,910,116,445,534,1611,106,831,1565,2475
457,Arunachal Pradesh,2004,02. Kidnapping & Abduction of Women & Girls,0,11,25,1,2,0,36,0,23,18,300,278,41,25,2,0,0,303,0,2,34,25,5,28,21,396,16,5,378,403
458,Assam,2004,02. Kidnapping & Abduction of Women & Girls,337,542,734,94,95,207,1276,0,2305,2236,2298,2090,1552,734,432,0,0,2824,671,155,2083,1248,194,2452,2502,3077,785,865,2849,4097
459,Bihar,2004,02. Kidnapping & Abduction of Women & Girls,380,137,444,1,71,99,581,0,1001,684,3112,3120,997,444,451,0,0,3564,791,0,1606,948,137,315,815,8764,158,928,8744,9692
460,Chandigarh,2004,02. Kidnapping & Abduction of Women & Girls,19,2,31,0,1,12,33,0,6,8,76,65,43,31,20,0,0,96,9,0,61,49,33,4,10,120,6,42,113,162
461,Chhattisgarh,2004,02. Kidnapping & Abduction of Women & Girls,172,9,153,103,77,18,162,0,38,44,528,727,174,153,249,0,0,880,181,93,225,219,81,2,7,989,1,262,1125,1344
462,Dadra & Nagar Haveli,2004,02. Kidnapping & Abduction of Women & Girls,4,0,4,0,0,0,4,0,6,3,8,8,7,4,4,0,0,12,3,0,6,5,0,0,1,17,0,3,15,20
463,Daman & Diu,2004,02. Kidnapping & Abduction of Women & Girls,0,0,0,0,0,0,0,0,0,0,0,0,0,0,0,0,0,0,0,0,0,0,0,0,0,0,0,0,0,0
464,Delhi,2004,02. Kidnapping & Abduction of Women & Girls,114,345,274,0,13,155,619,28,1069,1000,617,470,881,274,127,0,10,744,114,0,331,297,16,156,157,597,33,130,430,727
465,Goa,2004,02. Kidnapping & Abduction of Women & Girls,4,5,4,0,1,0,9,0,7,6,22,23,10,4,5,0,0,27,6,0,14,8,1,4,6,40,4,7,39,47
466,Gujarat,2004,02. Kidnapping & Abduction of Women & Girls,413,146,611,14,46,121,757,2,137,112,4915,4777,905,611,459,0,0,5388,658,11,1171,1184,65,147,129,9077,5,723,8627,9811
467,Haryana,2004,02. Kidnapping & Abduction of Women & Girls,169,19,178,1,38,85,197,0,60,50,561,591,292,178,207,0,0,769,327,3,315,314,76,28,25,895,4,403,987,1301
468,Himachal Pradesh,2004,02. Kidnapping & Abduction of Women & Girls,39,3,32,0,4,45,35,0,50,31,160,171,99,32,43,0,0,203,49,0,73,49,3,11,17,343,18,52,346,395
469,Jammu & Kashmir,2004,02. Kidnapping & Abduction of Women & Girls,214,35,452,9,5,128,487,0,313,296,2781,2557,632,452,219,0,0,3009,350,11,672,653,5,4,5,4889,18,355,4602,5255
470,Jharkhand,2004,02. Kidnapping & Abduction of Women & Girls,130,39,163,8,36,27,202,0,63,114,756,767,178,163,166,0,0,930,73,29,336,266,67,145,192,1151,23,140,1054,1320
471,Karnataka,2004,02. Kidnapping & Abduction of Women & Girls,137,41,171,3,9,74,212,0,80,80,742,720,286,171,146,0,0,891,279,4,278,256,12,40,50,1110,12,291,1149,1405
472,Kerala,2004,02. Kidnapping & Abduction of Women & Girls,48,13,95,2,3,27,108,9,74,76,414,372,142,95,51,0,0,467,94,5,135,18,13,66,176,625,7,107,719,737
473,Lakshadweep,2004,02. Kidnapping & Abduction of Women & Girls,0,0,0,0,0,0,0,0,0,0,0,0,0,0,0,0,0,0,0,0,0,0,0,0,0,0,0,0,0,0
474,Madhya Pradesh,2004,02. Kidnapping & Abduction of Women & Girls,431,70,498,24,127,21,568,0,116,121,2587,2671,584,498,558,0,0,3169,634,50,986,988,178,32,29,5273,1,812,5147,6135
475,Maharashtra,2004,02. Kidnapping & Abduction of Women & Girls,413,90,579,14,31,72,669,0,239,194,4934,4813,787,579,444,0,1,5392,715,23,1125,1116,49,328,274,9108,63,764,8779,9895
476,Manipur,2004,02. Kidnapping & Abduction of Women & Girls,2,39,1,0,0,0,40,2,124,95,28,29,71,1,2,0,0,30,3,0,77,1,0,45,55,72,66,3,74,75
477,Meghalaya,2004,02. Kidnapping & Abduction of Women & Girls,2,3,9,0,0,0,12,0,29,23,87,80,18,9,2,0,0,89,2,0,16,12,0,35,36,117,3,2,107,119
478,Mizoram,2004,02. Kidnapping & Abduction of Women & Girls,0,0,0,0,0,0,0,0,1,1,1,1,0,0,0,0,0,1,0,0,0,0,0,0,0,3,0,0,3,3
479,Nagaland,2004,02. Kidnapping & Abduction of Women & Girls,0,3,11,0,10,0,14,0,10,20,32,31,4,11,10,0,0,42,2,0,2,17,45,18,3,14,0,47,44,61
480,Odisha,2004,02. Kidnapping & Abduction of Women & Girls,279,34,303,0,36,66,337,0,165,146,1343,1355,423,303,315,0,1,1658,422,0,477,493,45,84,68,2143,0,467,2117,2610
481,Puducherry,2004,02. Kidnapping & Abduction of Women & Girls,5,0,5,0,1,0,5,3,10,10,7,8,8,5,6,0,0,13,7,0,6,5,3,16,17,9,0,10,14,19
482,Punjab,2004,02. Kidnapping & Abduction of Women & Girls,91,48,170,7,73,98,218,1,148,154,553,554,311,170,164,0,0,724,142,5,266,342,156,372,265,728,31,298,689,1031
483,Rajasthan,2004,02. Kidnapping & Abduction of Women & Girls,467,193,598,24,183,1089,791,0,158,157,3583,3659,1881,598,650,0,0,4257,879,35,1245,1232,392,12,25,8569,0,1271,8643,9875
484,Sikkim,2004,02. Kidnapping & Abduction of Women & Girls,0,0,3,0,0,0,3,0,1,0,3,0,4,3,0,0,0,3,0,0,4,3,0,1,0,3,2,0,0,3
485,Tamil Nadu,2004,02. Kidnapping & Abduction of Women & Girls,232,99,370,9,40,225,469,9,299,312,844,755,692,370,272,0,2,1125,592,13,985,821,65,507,552,2079,119,657,1928,2749
486,Tripura,2004,02. Kidnapping & Abduction of Women & Girls,30,9,15,0,14,3,24,0,28,1,34,63,54,15,44,0,0,78,50,0,83,79,26,43,26,199,21,76,196,275
487,Uttar Pradesh,2004,02. Kidnapping & Abduction of Women & Girls,691,443,1526,33,768,242,1969,0,427,314,6541,6507,2324,1526,1459,0,0,8033,1335,95,3709,3265,1703,487,685,13960,246,3038,13828,17093
488,Uttarakhand,2004,02. Kidnapping & Abduction of Women & Girls,14,46,62,2,21,15,108,0,32,28,356,331,127,62,35,0,0,393,89,0,202,132,61,30,28,835,72,150,853,985
489,West Bengal,2004,02. Kidnapping & Abduction of Women & Girls,331,193,633,11,28,49,826,1,1090,948,5400,5137,1018,633,359,0,0,5770,722,21,1620,1166,64,1211,1574,7512,91,786,7153,8319
490,Andaman & Nicobar Islands,2005,02. Kidnapping & Abduction of Women & Girls,0,0,0,0,0,0,0,0,2,1,16,16,1,0,0,0,0,16,0,0,0,0,0,0,0,25,0,0,25,25
491,Andhra Pradesh,2005,02. Kidnapping & Abduction of Women & Girls,362,65,655,14,55,327,720,0,461,513,1631,1407,995,655,417,0,0,2062,634,24,1230,1036,98,534,631,1891,97,732,1611,2647
492,Arunachal Pradesh,2005,02. Kidnapping & Abduction of Women & Girls,6,13,29,7,6,0,42,0,20,23,310,300,39,29,12,0,0,329,6,7,28,20,6,21,15,397,14,12,396,416
493,Assam,2005,02. Kidnapping & Abduction of Women & Girls,351,409,726,138,113,160,1135,0,2466,2305,2422,2298,1456,726,464,0,0,3024,714,229,2250,1324,167,2502,2554,3291,874,881,3077,4401
494,Bihar,2005,02. Kidnapping & Abduction of Women & Girls,370,93,512,3,71,105,605,0,1220,1001,3180,3112,929,512,441,0,0,3624,688,6,1518,1217,124,815,644,9163,472,812,8764,9981
495,Chandigarh,2005,02. Kidnapping & Abduction of Women & Girls,13,5,12,0,0,19,17,0,15,6,75,76,45,12,13,0,0,88,17,0,39,26,0,10,10,129,13,17,120,146
496,Chhattisgarh,2005,02. Kidnapping & Abduction of Women & Girls,51,18,157,0,23,1,175,1,42,38,611,528,184,157,74,0,3,685,90,10,223,218,37,7,11,1070,1,127,989,1207
497,Dadra & Nagar Haveli,2005,02. Kidnapping & Abduction of Women & Girls,5,0,3,0,0,4,3,0,8,6,6,8,9,3,5,0,0,11,5,0,6,6,0,1,1,18,0,5,17,23
498,Daman & Diu,2005,02. Kidnapping & Abduction of Women & Girls,0,0,1,0,0,0,1,0,1,0,1,0,2,1,0,0,0,1,0,0,4,4,0,0,0,4,0,0,0,4
499,Delhi,2005,02. Kidnapping & Abduction of Women & Girls,51,311,279,0,15,170,590,15,1378,1069,830,617,1106,279,66,0,22,896,109,0,419,305,31,157,191,762,80,140,597,902
500,Goa,2005,02. Kidnapping & Abduction of Women & Girls,3,2,6,0,0,0,8,0,11,7,25,22,12,6,3,0,0,28,11,0,18,7,0,6,16,36,1,11,40,47
501,Gujarat,2005,02. Kidnapping & Abduction of Women & Girls,316,177,604,18,51,87,781,0,185,137,5134,4915,916,604,367,0,0,5519,577,29,1147,1106,73,129,170,9504,0,650,9077,10183
502,Haryana,2005,02. Kidnapping & Abduction of Women & Girls,94,17,164,0,49,116,181,0,107,60,582,561,344,164,143,0,0,725,192,0,274,252,67,25,43,888,4,259,895,1147
503,Himachal Pradesh,2005,02. Kidnapping & Abduction of Women & Girls,52,5,49,0,2,57,54,0,41,50,155,160,102,49,54,0,0,209,84,0,115,88,5,17,38,342,6,89,343,431
504,Jammu & Kashmir,2005,02. Kidnapping & Abduction of Women & Girls,212,19,455,0,7,115,474,0,382,313,3017,2781,658,455,219,0,0,3236,370,0,741,715,7,5,9,5227,22,377,4889,5604
505,Jharkhand,2005,02. Kidnapping & Abduction of Women & Girls,81,44,160,9,13,17,204,0,125,63,813,756,283,160,94,0,0,916,986,17,207,271,37,192,106,382,22,1023,1151,1422
506,Karnataka,2005,02. Kidnapping & Abduction of Women & Girls,208,36,151,0,11,71,187,2,132,80,674,742,312,151,219,0,0,893,270,48,270,247,13,50,60,1026,13,283,1110,1357
507,Kerala,2005,02. Kidnapping & Abduction of Women & Girls,48,9,94,0,4,19,103,0,81,74,456,414,129,94,52,0,0,508,142,0,179,262,17,176,90,728,3,159,625,887
508,Lakshadweep,2005,02. Kidnapping & Abduction of Women & Girls,0,0,0,0,0,0,0,0,0,0,0,0,0,0,0,0,0,0,0,0,0,0,0,0,0,0,0,0,0,0
509,Madhya Pradesh,2005,02. Kidnapping & Abduction of Women & Girls,566,86,486,113,177,24,572,0,124,116,2217,2587,604,486,743,0,0,3073,954,226,1047,1037,358,29,34,4772,5,1312,5273,6310
510,Maharashtra,2005,02. Kidnapping & Abduction of Women & Girls,381,111,571,10,34,64,682,2,342,239,5080,4934,851,571,415,0,0,5505,717,17,1338,1221,53,274,367,9542,24,770,9108,10329
511,Manipur,2005,02. Kidnapping & Abduction of Women & Girls,3,48,2,0,0,0,50,1,142,124,27,28,69,2,3,0,0,30,3,0,68,2,0,55,50,71,71,3,72,74
512,Meghalaya,2005,02. Kidnapping & Abduction of Women & Girls,3,4,3,0,0,0,7,0,41,29,87,87,19,3,3,0,0,90,24,0,16,2,0,36,46,95,4,24,117,119
513,Mizoram,2005,02. Kidnapping & Abduction of Women & Girls,0,0,1,1,0,0,1,0,0,1,1,1,0,1,0,0,0,2,0,0,0,0,2,0,0,1,0,2,3,3
514,Nagaland,2005,02. Kidnapping & Abduction of Women & Girls,20,7,10,0,18,0,17,0,2,10,4,32,9,10,38,0,0,42,2,0,6,8,17,3,0,3,1,19,14,22
515,Odisha,2005,02. Kidnapping & Abduction of Women & Girls,198,24,324,0,23,87,348,0,277,165,1446,1343,547,324,221,0,0,1667,291,0,530,520,37,68,70,2335,8,328,2143,2663
516,Puducherry,2005,02. Kidnapping & Abduction of Women & Girls,1,0,6,0,1,1,6,0,6,10,11,7,3,6,2,0,0,13,4,0,2,10,1,17,9,14,0,5,9,19
517,Punjab,2005,02. Kidnapping & Abduction of Women & Girls,70,44,163,1,17,92,207,0,178,148,628,553,329,163,87,0,0,716,147,3,361,295,34,265,291,839,40,181,728,1023
518,Rajasthan,2005,02. Kidnapping & Abduction of Women & Girls,368,220,494,35,155,884,714,0,109,158,3519,3583,1549,494,523,0,0,4077,804,79,926,933,362,25,15,8257,3,1166,8569,9502
519,Sikkim,2005,02. Kidnapping & Abduction of Women & Girls,0,0,2,0,0,0,2,0,1,1,5,3,2,2,0,0,0,5,0,0,3,1,0,0,1,4,1,0,3,4
520,Tamil Nadu,2005,02. Kidnapping & Abduction of Women & Girls,297,153,347,6,73,253,500,19,310,299,813,844,783,347,370,2,0,1189,753,5,911,964,146,552,366,2086,133,899,2026,2990
521,Tripura,2005,02. Kidnapping & Abduction of Women & Girls,35,23,37,0,8,0,60,0,11,28,28,34,43,37,43,0,0,71,103,1,69,59,11,26,24,143,12,114,199,258
522,Uttar Pradesh,2005,02. Kidnapping & Abduction of Women & Girls,643,424,1538,69,721,218,1962,0,503,427,6646,6541,2256,1538,1364,0,0,8079,1309,106,3593,3260,1517,685,789,14288,229,2826,13960,17220
523,Uttarakhand,2005,02. Kidnapping & Abduction of Women & Girls,38,36,65,1,39,17,101,0,39,32,343,356,125,65,77,0,0,421,48,0,223,136,69,28,63,854,52,117,835,971
524,West Bengal,2005,02. Kidnapping & Abduction of Women & Girls,320,176,799,13,66,24,975,0,1130,1090,5800,5400,1039,799,386,0,0,6199,646,29,1565,1442,211,1574,1472,8068,225,857,7512,8954
525,Andaman & Nicobar Islands,2006,02. Kidnapping & Abduction of Women & Girls,0,0,7,0,0,0,7,0,0,2,23,16,5,7,0,0,0,23,0,0,10,10,0,0,0,35,0,0,25,35
526,Andhra Pradesh,2006,02. Kidnapping & Abduction of Women & Girls,436,42,709,47,71,391,751,0,648,461,1786,1631,1329,709,507,0,0,2340,831,52,1326,1250,156,631,612,2102,95,987,1891,3141
527,Arunachal Pradesh,2006,02. Kidnapping & Abduction of Women & Girls,5,10,37,3,3,0,47,0,24,20,336,310,51,37,8,0,0,347,7,3,51,37,5,15,17,419,12,12,397,434
528,Assam,2006,02. Kidnapping & Abduction of Women & Girls,527,471,798,92,102,181,1269,0,2560,2466,2499,2422,1544,798,629,0,0,3220,804,187,1848,1011,113,2554,2606,3198,785,917,3291,4302
529,Bihar,2006,02. Kidnapping & Abduction of Women & Girls,461,270,643,4,118,217,913,0,1174,1220,3240,3180,1084,643,579,0,0,3823,971,10,1961,1350,218,644,1045,9314,210,1189,9163,10513
530,Chandigarh,2006,02. Kidnapping & Abduction of Women & Girls,24,4,27,0,5,24,31,0,17,15,73,75,57,27,29,0,0,102,54,0,50,46,7,10,6,114,8,61,129,175
531,Chhattisgarh,2006,02. Kidnapping & Abduction of Women & Girls,76,17,156,8,45,4,173,1,42,42,638,611,178,156,121,0,0,767,115,4,177,175,57,11,13,1069,0,172,1070,1245
532,Dadra & Nagar Haveli,2006,02. Kidnapping & Abduction of Women & Girls,1,2,9,0,0,4,11,0,7,8,14,6,14,9,1,0,0,15,1,0,7,8,0,1,0,25,0,1,18,26
533,Daman & Diu,2006,02. Kidnapping & Abduction of Women & Girls,1,0,1,0,0,0,1,0,1,1,1,1,1,1,1,0,0,2,4,0,1,1,0,0,0,1,0,4,4,5
534,Delhi,2006,02. Kidnapping & Abduction of Women & Girls,71,251,247,0,40,155,498,17,1751,1378,966,830,1066,247,111,0,23,1077,57,0,402,390,74,191,119,1021,84,131,762,1152
535,Goa,2006,02. Kidnapping & Abduction of Women & Girls,2,3,10,0,0,1,13,0,7,11,33,25,10,10,2,0,0,35,2,0,12,12,0,16,8,46,8,2,36,48
536,Gujarat,2006,02. Kidnapping & Abduction of Women & Girls,385,143,654,22,76,100,797,6,227,185,5305,5134,945,654,461,0,0,5788,676,47,1142,1152,135,170,159,9798,1,811,9504,10656
537,Haryana,2006,02. Kidnapping & Abduction of Women & Girls,131,25,263,0,55,139,288,0,111,107,659,582,431,263,186,0,0,845,191,0,395,403,64,43,35,1036,0,255,888,1291
538,Himachal Pradesh,2006,02. Kidnapping & Abduction of Women & Girls,32,7,45,4,6,53,52,0,45,41,158,155,109,45,38,0,0,200,51,11,77,75,7,38,22,348,18,58,342,417
539,Jammu & Kashmir,2006,02. Kidnapping & Abduction of Women & Girls,206,16,571,9,8,146,587,0,372,382,3365,3017,723,571,214,0,0,3588,341,14,862,853,18,9,4,5707,14,359,5227,6080
540,Jharkhand,2006,02. Kidnapping & Abduction of Women & Girls,133,59,250,3,25,34,309,0,192,125,902,813,410,250,158,0,0,1063,191,33,378,289,42,106,175,405,20,233,382,671
541,Karnataka,2006,02. Kidnapping & Abduction of Women & Girls,144,43,198,1,8,84,241,5,129,132,719,674,328,198,152,0,1,872,243,1,357,310,15,60,79,1077,28,258,1026,1336
542,Kerala,2006,02. Kidnapping & Abduction of Women & Girls,66,7,149,3,4,16,156,0,111,81,532,456,202,149,70,0,0,605,119,6,219,175,10,90,134,768,0,129,728,903
543,Lakshadweep,2006,02. Kidnapping & Abduction of Women & Girls,0,0,0,0,0,0,0,0,0,0,0,0,0,0,0,0,0,0,0,0,0,0,0,0,0,0,0,0,0,0
544,Madhya Pradesh,2006,02. Kidnapping & Abduction of Women & Girls,420,72,515,2,215,14,587,0,140,124,2095,2217,617,515,635,0,0,2732,655,3,869,860,337,34,43,4637,0,992,4772,5632
545,Maharashtra,2006,02. Kidnapping & Abduction of Women & Girls,298,126,609,14,36,84,735,0,444,342,5341,5080,921,609,334,0,0,5689,606,20,1324,1155,60,367,472,10011,64,666,9542,10697
546,Manipur,2006,02. Kidnapping & Abduction of Women & Girls,0,63,0,0,1,0,63,0,158,142,26,27,79,0,1,0,0,27,1,0,49,0,0,50,72,70,27,1,71,71
547,Meghalaya,2006,02. Kidnapping & Abduction of Women & Girls,3,6,10,1,0,0,16,0,50,41,93,87,25,10,3,0,0,97,4,1,27,15,0,46,56,105,2,4,95,110
548,Mizoram,2006,02. Kidnapping & Abduction of Women & Girls,0,0,1,0,2,0,1,0,0,0,0,1,1,1,2,0,0,2,0,0,1,1,2,0,0,0,0,2,1,2
549,Nagaland,2006,02. Kidnapping & Abduction of Women & Girls,0,0,3,0,2,0,3,0,2,2,5,4,3,3,2,0,0,7,1,0,5,5,6,0,0,1,0,7,3,8
550,Odisha,2006,02. Kidnapping & Abduction of Women & Girls,233,26,396,0,46,91,422,1,340,277,1563,1446,577,396,279,0,0,1842,412,0,558,536,63,70,92,2396,0,475,2335,2871
551,Puducherry,2006,02. Kidnapping & Abduction of Women & Girls,2,0,8,0,0,1,8,1,9,6,17,11,13,8,2,0,0,19,2,0,20,14,0,9,15,26,0,2,14,28
552,Punjab,2006,02. Kidnapping & Abduction of Women & Girls,76,58,162,0,19,103,220,0,273,178,695,628,418,162,95,0,0,790,178,0,471,282,43,291,438,900,42,221,839,1121
553,Rajasthan,2006,02. Kidnapping & Abduction of Women & Girls,352,161,546,24,225,859,707,0,96,109,3464,3519,1553,546,577,0,0,4065,784,118,1011,1012,571,15,12,7796,2,1355,8257,9269
554,Sikkim,2006,02. Kidnapping & Abduction of Women & Girls,0,1,4,0,0,0,5,0,3,1,9,5,7,4,0,0,0,9,0,0,0,1,0,1,0,5,0,0,4,5
555,Tamil Nadu,2006,02. Kidnapping & Abduction of Women & Girls,307,100,350,11,58,195,450,10,359,310,787,813,718,350,365,0,14,1163,808,5,1052,691,174,366,568,1790,159,982,2086,2777
556,Tripura,2006,02. Kidnapping & Abduction of Women & Girls,12,22,27,0,8,0,49,0,24,11,35,28,62,27,20,0,0,55,16,0,61,42,5,24,21,164,22,21,143,185
557,Uttar Pradesh,2006,02. Kidnapping & Abduction of Women & Girls,839,577,1815,66,903,257,2392,0,405,503,6653,6646,2551,1815,1742,0,0,8461,1600,116,4270,3965,2018,789,670,14519,424,3618,14288,18253
558,Uttarakhand,2006,02. Kidnapping & Abduction of Women & Girls,41,42,133,27,49,17,175,0,30,39,359,343,183,133,90,0,0,476,94,17,314,255,138,63,61,860,61,232,854,1109
559,West Bengal,2006,02. Kidnapping & Abduction of Women & Girls,626,233,838,19,120,24,1071,0,1234,1130,5873,5800,1199,838,746,0,0,6638,1005,41,1660,1251,180,1472,1558,8093,323,1185,8068,9319
560,Andaman & Nicobar Islands,2007,02. Kidnapping & Abduction of Women & Girls,2,0,3,0,0,0,3,0,6,0,24,23,9,3,2,0,0,26,6,0,6,3,0,0,3,32,0,6,35,38
561,Andhra Pradesh,2007,02. Kidnapping & Abduction of Women & Girls,496,47,1003,84,60,495,1050,0,667,648,2149,1786,1564,1003,556,0,0,2789,804,128,1674,1424,129,612,802,2465,60,933,2102,3526
562,Arunachal Pradesh,2007,02. Kidnapping & Abduction of Women & Girls,1,13,33,2,4,0,46,0,22,24,362,336,44,33,5,0,0,369,2,1,51,37,5,17,12,448,19,7,419,456
563,Assam,2007,02. Kidnapping & Abduction of Women & Girls,575,413,886,82,250,167,1299,0,2565,2560,2478,2499,1471,886,825,0,0,3385,807,64,1721,1034,225,2606,2639,3136,654,1032,3198,4232
564,Bihar,2007,02. Kidnapping & Abduction of Women & Girls,598,213,787,8,78,248,1000,0,1186,1174,3343,3240,1260,787,676,0,0,4027,1256,21,2085,1742,157,1045,1189,9622,199,1413,9314,11056
565,Chandigarh,2007,02. Kidnapping & Abduction of Women & Girls,16,1,23,0,10,14,24,0,25,17,70,73,46,23,26,0,0,96,20,0,45,31,13,6,14,112,6,33,114,145
566,Chhattisgarh,2007,02. Kidnapping & Abduction of Women & Girls,51,16,148,1,16,7,164,0,52,42,718,638,181,148,67,0,0,786,64,1,196,198,38,13,11,1164,0,102,1069,1267
567,Dadra & Nagar Haveli,2007,02. Kidnapping & Abduction of Women & Girls,3,2,5,0,0,1,7,0,5,7,16,14,6,5,3,0,0,19,3,0,7,7,0,0,0,29,0,3,25,32
568,Daman & Diu,2007,02. Kidnapping & Abduction of Women & Girls,0,0,1,0,0,0,1,0,1,1,2,1,1,1,0,0,0,2,0,0,3,3,0,0,0,4,0,0,1,4
569,Delhi,2007,02. Kidnapping & Abduction of Women & Girls,68,314,277,0,38,198,591,28,2082,1751,1137,966,1167,277,106,0,19,1243,68,0,352,204,80,119,185,1077,82,148,1021,1225
570,Goa,2007,02. Kidnapping & Abduction of Women & Girls,2,3,2,0,2,0,5,0,9,7,31,33,7,2,4,0,0,35,6,0,8,2,3,8,11,39,3,9,46,48
571,Gujarat,2007,02. Kidnapping & Abduction of Women & Girls,277,182,789,6,55,95,971,6,244,227,5756,5305,1089,789,332,0,0,6094,474,23,1356,1310,87,159,204,10524,1,561,9798,11108
572,Haryana,2007,02. Kidnapping & Abduction of Women & Girls,170,25,311,1,50,170,336,0,159,111,749,659,554,311,220,0,0,970,305,3,490,463,95,35,62,1096,0,400,1036,1499
573,Himachal Pradesh,2007,02. Kidnapping & Abduction of Women & Girls,34,8,51,5,3,71,59,0,65,45,167,158,150,51,37,0,0,209,50,8,106,75,7,22,46,358,7,57,348,423
574,Jammu & Kashmir,2007,02. Kidnapping & Abduction of Women & Girls,278,41,496,2,2,197,537,0,345,372,3579,3365,707,496,280,0,0,3861,476,19,959,956,2,4,3,6166,4,478,5707,6663
575,Jharkhand,2007,02. Kidnapping & Abduction of Women & Girls,298,74,339,3,125,23,413,0,290,192,815,902,534,339,423,0,0,1241,240,0,549,487,129,175,218,523,19,369,405,892
576,Karnataka,2007,02. Kidnapping & Abduction of Women & Girls,138,79,194,0,13,92,273,10,143,129,762,719,390,194,151,0,1,913,297,3,373,337,25,79,92,1089,23,322,1077,1414
577,Kerala,2007,02. Kidnapping & Abduction of Women & Girls,56,8,147,3,9,12,155,0,121,111,611,532,177,147,65,0,0,679,122,4,194,214,14,134,114,842,0,136,768,982
578,Lakshadweep,2007,02. Kidnapping & Abduction of Women & Girls,0,0,0,0,0,0,0,0,0,0,0,0,0,0,0,0,0,0,0,0,0,0,0,0,0,0,0,0,0,0
579,Madhya Pradesh,2007,02. Kidnapping & Abduction of Women & Girls,450,89,585,47,146,20,674,0,147,140,2037,2095,701,585,596,0,0,2680,794,49,906,920,301,43,29,4413,0,1095,4637,5557
580,Maharashtra,2007,02. Kidnapping & Abduction of Women & Girls,292,121,676,15,53,96,797,0,518,444,5657,5341,967,676,345,0,0,6017,543,23,1286,1243,79,472,467,10609,48,622,10011,11254
581,Manipur,2007,02. Kidnapping & Abduction of Women & Girls,4,48,1,0,1,0,49,0,192,158,22,26,83,1,5,0,0,27,4,0,59,1,1,72,65,66,65,5,70,71
582,Meghalaya,2007,02. Kidnapping & Abduction of Women & Girls,1,4,3,0,4,0,7,0,65,50,91,93,22,3,5,0,0,96,3,0,12,15,6,56,49,111,4,9,105,120
583,Mizoram,2007,02. Kidnapping & Abduction of Women & Girls,0,0,0,0,0,0,0,0,0,0,0,0,0,0,0,0,0,0,0,0,0,0,0,0,0,0,0,0,0,0
584,Nagaland,2007,02. Kidnapping & Abduction of Women & Girls,0,0,3,0,2,0,3,0,5,2,6,5,6,3,2,0,0,8,0,0,12,11,7,0,1,5,0,7,1,12
585,Odisha,2007,02. Kidnapping & Abduction of Women & Girls,173,35,402,1,28,59,437,0,504,340,1763,1563,660,402,201,0,0,1965,317,0,681,684,61,92,80,2702,9,378,2396,3080
586,Puducherry,2007,02. Kidnapping & Abduction of Women & Girls,4,1,9,0,1,3,10,4,6,9,21,17,14,9,5,0,0,26,8,0,14,18,3,15,9,33,2,11,26,44
587,Punjab,2007,02. Kidnapping & Abduction of Women & Girls,77,121,210,3,26,151,331,0,336,273,799,695,545,210,103,0,0,905,165,4,592,381,63,438,590,1049,59,228,900,1281
588,Rajasthan,2007,02. Kidnapping & Abduction of Women & Girls,328,160,556,19,132,962,716,0,112,96,3541,3464,1694,556,460,0,0,4020,674,22,942,944,270,12,10,7774,0,944,7796,8740
589,Sikkim,2007,02. Kidnapping & Abduction of Women & Girls,0,0,2,0,0,0,2,0,10,3,11,9,9,2,0,0,0,11,0,0,3,3,0,0,0,8,0,0,5,8
590,Tamil Nadu,2007,02. Kidnapping & Abduction of Women & Girls,326,157,453,1,53,253,610,30,558,359,860,787,1097,453,379,0,5,1240,759,0,1107,835,118,568,700,1748,140,877,1790,2625
591,Tripura,2007,02. Kidnapping & Abduction of Women & Girls,4,11,66,0,5,0,77,0,28,24,92,35,81,66,9,0,0,101,43,0,81,80,12,21,18,189,4,55,164,244
592,Uttar Pradesh,2007,02. Kidnapping & Abduction of Women & Girls,860,879,1948,61,804,415,2827,0,526,405,6876,6653,3363,1948,1664,0,0,8601,1991,110,5683,4166,1843,670,919,14741,1268,3834,14519,18685
593,Uttarakhand,2007,02. Kidnapping & Abduction of Women & Girls,31,55,120,0,37,39,175,0,43,30,411,359,227,120,68,0,0,479,90,0,363,269,76,61,89,963,66,166,860,1129
594,West Bengal,2007,02. Kidnapping & Abduction of Women & Girls,422,310,931,15,31,29,1241,0,1554,1234,6336,5873,1590,931,453,0,0,6804,943,86,1742,1549,56,1558,1501,8557,250,999,8093,9642
595,Andaman & Nicobar Islands,2008,02. Kidnapping & Abduction of Women & Girls,1,4,7,0,0,0,11,0,8,6,30,24,13,7,1,0,0,31,1,0,10,10,0,3,3,41,0,1,32,42
596,Andhra Pradesh,2008,02. Kidnapping & Abduction of Women & Girls,573,122,925,71,37,470,1047,0,546,667,2393,2149,1396,925,610,0,0,3074,911,36,1606,1635,96,802,708,3057,65,1007,2465,4100
597,Arunachal Pradesh,2008,02. Kidnapping & Abduction of Women & Girls,4,12,26,1,4,0,38,0,31,22,379,362,47,26,8,0,0,388,5,2,57,35,7,12,23,469,11,12,448,483
598,Assam,2008,02. Kidnapping & Abduction of Women & Girls,378,531,780,35,89,194,1311,0,2849,2565,2756,2478,1789,780,467,0,0,3258,854,106,1965,1269,248,2639,2536,3197,799,1102,3136,4405
599,Bihar,2008,02. Kidnapping & Abduction of Women & Girls,475,371,837,5,138,317,1208,0,1450,1186,3562,3343,1789,837,613,0,0,4180,1101,14,2382,1978,264,1189,1518,10221,75,1365,9622,11600
600,Chandigarh,2008,02. Kidnapping & Abduction of Women & Girls,22,19,13,0,8,4,32,0,31,25,53,70,42,13,30,0,0,83,37,0,42,22,21,14,22,76,12,58,112,134
601,Chhattisgarh,2008,02. Kidnapping & Abduction of Women & Girls,91,20,178,145,23,6,198,0,64,52,637,718,216,178,114,0,0,896,129,2,229,210,33,11,30,1210,0,162,1164,1374
602,Dadra & Nagar Haveli,2008,02. Kidnapping & Abduction of Women & Girls,1,0,6,0,0,0,6,0,10,5,21,16,11,6,1,0,0,22,1,0,16,8,0,0,8,36,0,1,29,37
603,Daman & Diu,2008,02. Kidnapping & Abduction of Women & Girls,0,0,0,0,0,0,0,0,2,1,2,2,1,0,0,0,0,2,0,0,0,0,0,0,0,4,0,0,4,4
604,Delhi,2008,02. Kidnapping & Abduction of Women & Girls,127,540,405,0,27,278,945,33,1941,2082,1388,1137,1136,405,154,0,21,1542,161,0,412,458,41,185,91,1333,48,202,1077,1535
605,Goa,2008,02. Kidnapping & Abduction of Women & Girls,5,3,8,0,1,0,11,0,26,9,33,31,28,8,6,0,0,39,5,0,28,10,1,11,28,43,1,6,39,49
606,Gujarat,2008,02. Kidnapping & Abduction of Women & Girls,322,202,764,9,44,96,966,5,295,244,6145,5756,1119,764,366,0,1,6520,512,8,1320,1324,67,204,194,11261,6,579,10524,11848
607,Haryana,2008,02. Kidnapping & Abduction of Women & Girls,171,40,327,1,71,253,367,0,183,159,833,749,644,327,242,0,0,1076,250,2,594,563,90,62,92,1317,1,340,1096,1659
608,Himachal Pradesh,2008,02. Kidnapping & Abduction of Women & Girls,31,6,67,1,10,74,73,0,55,65,192,167,137,67,41,0,0,234,65,1,144,133,17,46,45,408,12,82,358,491
609,Jammu & Kashmir,2008,02. Kidnapping & Abduction of Women & Girls,242,14,267,13,1,223,281,0,497,345,3590,3579,656,267,243,0,0,3846,387,6,523,524,1,3,2,6296,0,388,6166,6690
610,Jharkhand,2008,02. Kidnapping & Abduction of Women & Girls,237,97,318,17,57,39,415,3,332,290,822,815,499,318,294,0,0,1133,223,21,604,533,92,218,269,720,20,315,523,1056
611,Karnataka,2008,02. Kidnapping & Abduction of Women & Girls,197,67,201,4,6,83,268,10,187,143,756,762,405,201,203,0,0,963,264,10,487,394,11,92,174,1198,11,275,1089,1483
612,Kerala,2008,02. Kidnapping & Abduction of Women & Girls,105,21,155,0,1,23,176,0,88,121,660,611,166,155,106,0,0,766,139,0,179,194,5,114,99,892,0,144,842,1036
613,Lakshadweep,2008,02. Kidnapping & Abduction of Women & Girls,0,0,0,0,0,0,0,0,1,0,0,0,1,0,0,0,0,0,0,0,1,0,0,0,1,0,0,0,0,0
614,Madhya Pradesh,2008,02. Kidnapping & Abduction of Women & Girls,454,59,619,6,204,15,678,0,190,147,1992,2037,736,619,658,0,0,2656,639,20,1013,1006,215,29,36,4545,0,854,4413,5419
615,Maharashtra,2008,02. Kidnapping & Abduction of Women & Girls,404,140,723,27,47,88,863,0,565,518,5902,5657,998,723,451,0,0,6380,687,57,1487,1351,63,467,566,11153,37,750,10609,11960
616,Manipur,2008,02. Kidnapping & Abduction of Women & Girls,0,25,0,0,0,0,25,0,254,192,22,22,87,0,0,0,0,22,0,0,68,0,0,65,44,66,89,0,66,66
617,Meghalaya,2008,02. Kidnapping & Abduction of Women & Girls,4,5,3,0,0,0,8,0,82,65,90,91,25,3,4,0,0,94,4,0,14,3,0,49,57,110,3,4,111,114
618,Mizoram,2008,02. Kidnapping & Abduction of Women & Girls,0,0,1,0,0,0,1,0,0,0,1,0,1,1,0,0,0,1,0,0,1,1,0,0,0,1,0,0,0,1
619,Nagaland,2008,02. Kidnapping & Abduction of Women & Girls,0,2,4,0,5,0,6,0,6,5,5,6,7,4,5,0,0,10,0,0,5,3,1,1,1,7,2,1,5,8
620,Odisha,2008,02. Kidnapping & Abduction of Women & Girls,282,25,504,0,67,60,529,0,677,504,1918,1763,762,504,349,0,0,2267,403,1,633,602,71,80,111,2829,0,474,2702,3304
621,Puducherry,2008,02. Kidnapping & Abduction of Women & Girls,4,0,5,0,0,0,5,0,10,6,22,21,9,5,4,0,0,26,4,0,8,7,0,9,10,36,0,4,33,40
622,Punjab,2008,02. Kidnapping & Abduction of Women & Girls,88,92,257,1,22,172,349,0,329,336,945,799,514,257,110,0,0,1056,159,2,573,470,42,590,616,1316,77,201,1049,1519
623,Rajasthan,2008,02. Kidnapping & Abduction of Women & Girls,275,194,612,13,121,995,806,0,174,112,3744,3541,1863,612,396,0,0,4153,497,25,942,938,169,10,14,8021,0,666,7774,8712
624,Sikkim,2008,02. Kidnapping & Abduction of Women & Girls,1,1,5,0,1,0,6,0,8,10,14,11,4,5,2,0,0,16,1,0,8,8,1,0,0,14,0,2,8,16
625,Tamil Nadu,2008,02. Kidnapping & Abduction of Women & Girls,349,258,521,6,138,301,779,0,637,558,888,860,1160,521,487,0,1,1381,683,0,1405,1116,263,700,887,1918,102,946,1748,2864
626,Tripura,2008,02. Kidnapping & Abduction of Women & Girls,26,23,87,4,4,0,110,0,28,28,145,92,110,87,30,0,0,179,43,5,112,93,12,18,17,222,20,55,189,282
627,Uttar Pradesh,2008,02. Kidnapping & Abduction of Women & Girls,1046,1185,2571,22,1172,624,3756,0,585,526,7207,6876,4439,2571,2218,0,0,9447,2366,29,8280,5932,2782,919,1231,15496,2036,5148,14741,20673
628,Uttarakhand,2008,02. Kidnapping & Abduction of Women & Girls,44,69,125,1,44,21,194,0,50,43,447,411,222,125,88,0,0,536,161,0,203,174,118,89,47,858,71,279,963,1137
629,West Bengal,2008,02. Kidnapping & Abduction of Women & Girls,440,200,1130,16,36,47,1330,0,2084,1554,6974,6336,1907,1130,476,0,0,7466,1021,202,1857,1466,58,1501,1740,8742,152,1079,8557,10023
630,Andaman & Nicobar Islands,2009,02. Kidnapping & Abduction of Women & Girls,2,7,2,0,0,0,9,0,13,8,30,30,14,2,2,0,0,32,6,0,5,2,0,3,6,37,0,6,41,43
631,Andhra Pradesh,2009,02. Kidnapping & Abduction of Women & Girls,744,117,968,51,50,398,1085,0,589,546,2513,2393,1526,968,794,3,0,3358,1319,53,1889,1637,93,708,813,3229,147,1412,3057,4694
632,Arunachal Pradesh,2009,02. Kidnapping & Abduction of Women & Girls,5,8,31,1,4,0,39,0,20,31,400,379,28,31,9,0,0,410,6,1,38,34,4,23,20,492,7,10,469,503
633,Assam,2009,02. Kidnapping & Abduction of Women & Girls,319,572,774,52,77,228,1346,13,3354,2849,3082,2756,2092,774,396,0,0,3530,591,118,2392,1159,118,2536,2706,3529,1063,709,3197,4356
634,Bihar,2009,02. Kidnapping & Abduction of Women & Girls,526,464,772,11,114,354,1236,0,1846,1450,3683,3562,1986,772,640,0,0,4334,1326,21,2397,1961,300,1518,1813,10535,141,1626,10221,12182
635,Chandigarh,2009,02. Kidnapping & Abduction of Women & Girls,13,1,17,0,11,15,18,0,34,31,46,53,36,17,24,0,0,70,23,0,29,23,13,22,26,63,2,36,76,99
636,Chhattisgarh,2009,02. Kidnapping & Abduction of Women & Girls,81,18,173,0,40,25,191,0,77,64,689,637,229,173,121,0,0,810,121,0,267,250,43,30,47,1296,0,164,1210,1460
637,Dadra & Nagar Haveli,2009,02. Kidnapping & Abduction of Women & Girls,1,0,10,0,2,1,10,0,8,10,28,21,9,10,3,0,0,31,1,0,12,18,3,8,2,50,0,4,36,54
638,Daman & Diu,2009,02. Kidnapping & Abduction of Women & Girls,0,0,0,0,0,0,0,0,2,2,2,2,0,0,0,0,0,2,0,0,0,0,0,0,0,4,0,0,4,4
639,Delhi,2009,02. Kidnapping & Abduction of Women & Girls,104,604,293,0,46,354,897,37,2247,1941,1531,1388,1655,293,150,0,61,1681,105,0,375,378,57,91,68,1549,20,162,1333,1711
640,Goa,2009,02. Kidnapping & Abduction of Women & Girls,12,8,13,0,0,3,21,0,24,26,34,33,22,13,12,0,0,46,14,0,18,22,0,28,17,51,7,14,43,65
641,Gujarat,2009,02. Kidnapping & Abduction of Women & Girls,294,211,808,8,42,64,1019,9,365,295,6609,6145,1162,808,336,0,0,6953,472,10,1494,1493,73,194,194,12199,1,545,11261,12754
642,Haryana,2009,02. Kidnapping & Abduction of Women & Girls,210,21,339,0,74,286,360,0,196,183,888,833,659,339,284,0,0,1172,384,0,530,549,104,92,73,1378,0,488,1317,1866
643,Himachal Pradesh,2009,02. Kidnapping & Abduction of Women & Girls,39,4,66,2,5,63,70,0,44,55,212,192,122,66,44,0,0,258,85,10,102,106,17,45,34,402,7,102,408,514
644,Jammu & Kashmir,2009,02. Kidnapping & Abduction of Women & Girls,370,23,427,1,11,390,450,0,482,497,3635,3590,825,427,381,0,0,4017,554,4,696,694,10,2,4,6422,0,564,6296,6990
645,Jharkhand,2009,02. Kidnapping & Abduction of Women & Girls,295,87,366,35,129,53,453,0,343,332,729,822,517,366,424,0,0,1188,330,20,397,399,129,269,253,640,14,459,720,1119
646,Karnataka,2009,02. Kidnapping & Abduction of Women & Girls,136,59,245,8,5,96,304,4,191,187,852,756,408,245,141,0,0,1001,325,22,506,490,16,174,176,1325,14,341,1198,1688
647,Kerala,2009,02. Kidnapping & Abduction of Women & Girls,81,11,131,1,8,13,142,0,106,88,701,660,173,131,89,0,0,791,128,2,202,185,14,99,116,933,0,142,892,1077
648,Lakshadweep,2009,02. Kidnapping & Abduction of Women & Girls,0,0,1,0,0,0,1,0,0,1,1,0,0,1,0,0,0,1,0,0,0,1,0,1,0,1,0,0,0,1
649,Madhya Pradesh,2009,02. Kidnapping & Abduction of Women & Girls,285,68,679,13,121,19,747,0,265,190,2252,1992,841,679,406,0,0,2671,551,9,1060,1042,188,36,54,4839,0,739,4545,5587
650,Maharashtra,2009,02. Kidnapping & Abduction of Women & Girls,292,129,722,11,31,89,851,1,550,565,6290,5902,926,722,323,0,0,6624,576,24,1388,1388,61,566,488,11880,78,637,11153,12541
651,Manipur,2009,02. Kidnapping & Abduction of Women & Girls,0,33,1,0,0,0,34,0,317,254,23,22,97,1,0,0,0,23,0,0,95,1,0,44,81,66,57,0,65,66
652,Meghalaya,2009,02. Kidnapping & Abduction of Women & Girls,13,6,5,0,0,0,11,0,97,82,82,90,26,5,13,0,0,95,18,0,17,10,0,57,59,102,5,18,110,120
653,Mizoram,2009,02. Kidnapping & Abduction of Women & Girls,0,0,0,0,1,0,0,0,0,0,0,1,0,0,1,0,0,1,0,0,0,0,1,0,0,0,0,1,1,1
654,Nagaland,2009,02. Kidnapping & Abduction of Women & Girls,0,2,8,0,1,0,10,0,6,6,12,5,10,8,1,0,0,13,0,0,8,4,9,1,0,2,5,9,7,11
655,Odisha,2009,02. Kidnapping & Abduction of Women & Girls,236,15,485,0,40,55,500,0,921,677,2127,1918,799,485,276,0,0,2403,357,0,814,762,52,111,163,3182,0,409,2829,3591
656,Puducherry,2009,02. Kidnapping & Abduction of Women & Girls,3,1,13,0,0,4,14,1,4,10,32,22,13,13,3,0,0,35,6,0,11,13,0,10,8,43,0,6,36,49
657,Punjab,2009,02. Kidnapping & Abduction of Women & Girls,158,87,212,0,34,184,299,0,359,329,965,945,513,212,192,0,0,1157,294,0,566,358,66,616,713,1314,111,360,1316,1674
658,Rajasthan,2009,02. Kidnapping & Abduction of Women & Girls,243,223,732,9,120,1298,955,0,231,174,4104,3744,2310,732,363,0,0,4476,501,14,1138,1132,198,14,20,8440,0,699,8021,9153
659,Sikkim,2009,02. Kidnapping & Abduction of Women & Girls,2,0,3,0,2,0,3,0,11,8,13,14,6,3,4,0,0,17,5,1,7,4,3,0,1,9,2,8,14,18
660,Tamil Nadu,2009,02. Kidnapping & Abduction of Women & Girls,246,262,527,11,56,319,789,0,662,637,1102,888,1133,527,302,0,0,1415,659,4,1312,1090,126,887,991,2219,118,785,1918,3008
661,Tripura,2009,02. Kidnapping & Abduction of Women & Girls,32,21,71,0,6,0,92,0,28,28,178,145,92,71,38,0,0,216,65,3,125,73,10,17,42,217,27,75,222,295
662,Uttar Pradesh,2009,02. Kidnapping & Abduction of Women & Girls,1244,1283,2941,8,1251,722,4224,0,717,585,7645,7207,5078,2941,2495,0,0,10148,3489,54,10487,6777,3527,1231,1469,15203,3472,7016,15496,22273
663,Uttarakhand,2009,02. Kidnapping & Abduction of Women & Girls,47,76,150,10,36,26,226,0,45,50,504,447,247,150,83,0,0,597,114,0,191,193,97,47,38,840,7,211,858,1051
664,West Bengal,2009,02. Kidnapping & Abduction of Women & Girls,369,321,1137,13,31,54,1458,1,2758,2084,7698,6974,2187,1137,400,0,0,8111,858,86,1958,1790,27,1740,1783,9561,125,885,8742,10532
665,Andaman & Nicobar Islands,2010,02. Kidnapping & Abduction of Women & Girls,0,3,7,0,0,0,10,0,11,13,37,30,8,7,0,0,0,37,0,0,11,16,0,6,1,53,0,0,37,53
666,Andhra Pradesh,2010,02. Kidnapping & Abduction of Women & Girls,749,58,1101,58,75,410,1159,0,551,589,2732,2513,1531,1101,824,0,0,3614,1265,114,1722,1816,128,813,622,3538,97,1393,3229,5045
667,Arunachal Pradesh,2010,02. Kidnapping & Abduction of Women & Girls,2,15,21,5,2,0,36,0,30,20,412,400,46,21,4,0,0,421,3,7,48,29,2,20,26,509,13,5,492,521
668,Assam,2010,02. Kidnapping & Abduction of Women & Girls,509,730,971,22,106,231,1701,63,4126,3354,3416,3082,2767,971,615,0,0,4053,671,130,2687,1218,146,2706,3078,3800,1097,817,3529,4747
669,Bihar,2010,02. Kidnapping & Abduction of Women & Girls,581,593,1150,15,108,410,1743,0,2262,1846,4129,3683,2569,1150,689,0,0,4833,1440,19,2503,2280,196,1813,1916,11160,120,1636,10535,12815
670,Chandigarh,2010,02. Kidnapping & Abduction of Women & Girls,8,2,1,0,6,30,3,0,29,34,33,46,28,1,14,0,0,47,13,0,23,8,8,26,17,50,24,21,63,71
671,Chhattisgarh,2010,02. Kidnapping & Abduction of Women & Girls,109,34,192,1,36,13,226,0,117,77,735,689,279,192,145,0,0,881,144,1,352,321,58,47,71,1414,7,202,1296,1617
672,Dadra & Nagar Haveli,2010,02. Kidnapping & Abduction of Women & Girls,2,0,3,0,1,2,3,0,13,8,28,28,10,3,3,0,0,31,2,0,7,3,1,2,6,50,0,3,50,53
673,Daman & Diu,2010,02. Kidnapping & Abduction of Women & Girls,0,1,0,0,0,0,1,0,3,2,2,2,2,0,0,0,0,2,0,0,0,0,0,0,0,4,0,0,4,4
674,Delhi,2010,02. Kidnapping & Abduction of Women & Girls,141,656,289,0,85,537,945,26,2407,2247,1594,1531,1740,289,226,0,72,1820,155,0,366,352,85,68,71,1661,11,240,1549,1901
675,Goa,2010,02. Kidnapping & Abduction of Women & Girls,8,7,10,0,1,3,17,0,22,24,35,34,18,10,9,0,0,44,13,0,15,18,2,17,12,54,2,15,51,69
676,Gujarat,2010,02. Kidnapping & Abduction of Women & Girls,350,229,1027,17,51,50,1256,10,338,365,7218,6609,1290,1027,401,0,1,7636,712,21,1651,1580,100,194,263,12946,2,812,12199,13779
677,Haryana,2010,02. Kidnapping & Abduction of Women & Girls,259,21,431,0,91,260,452,0,198,196,969,888,714,431,350,0,0,1319,356,0,543,524,130,73,92,1416,0,486,1378,1902
678,Himachal Pradesh,2010,02. Kidnapping & Abduction of Women & Girls,28,3,55,3,5,83,58,0,65,44,231,212,162,55,33,0,0,267,74,3,101,95,5,34,40,415,0,79,402,497
679,Jammu & Kashmir,2010,02. Kidnapping & Abduction of Women & Girls,250,31,346,5,5,423,377,0,522,482,3721,3635,840,346,255,0,0,3981,436,13,509,503,10,4,10,6466,0,446,6422,6925
680,Jharkhand,2010,02. Kidnapping & Abduction of Women & Girls,309,108,420,0,67,63,528,0,448,343,773,729,696,420,376,0,0,1149,380,3,710,674,103,253,282,828,7,483,640,1314
681,Karnataka,2010,02. Kidnapping & Abduction of Women & Girls,186,105,328,3,14,137,433,8,197,191,977,852,586,328,200,0,2,1180,344,85,751,614,47,176,266,1463,47,391,1325,1939
682,Kerala,2010,02. Kidnapping & Abduction of Women & Girls,72,12,174,0,4,17,186,0,87,106,799,701,184,174,76,0,0,875,95,0,221,257,5,116,80,1090,0,100,933,1190
683,Lakshadweep,2010,02. Kidnapping & Abduction of Women & Girls,0,0,0,0,0,0,0,0,0,0,1,1,0,0,0,0,0,1,0,0,0,0,0,0,0,1,0,0,1,1
684,Madhya Pradesh,2010,02. Kidnapping & Abduction of Women & Girls,433,86,856,11,208,20,942,0,333,265,2456,2252,1030,856,641,0,0,3108,833,14,1303,1309,390,54,48,4911,0,1223,4839,6148
685,Maharashtra,2010,02. Kidnapping & Abduction of Women & Girls,366,138,706,9,21,99,844,9,722,550,6600,6290,1124,706,387,0,0,6996,655,14,1470,1250,43,488,663,12418,45,698,11880,13130
686,Manipur,2010,02. Kidnapping & Abduction of Women & Girls,2,38,2,0,0,0,40,0,384,317,23,23,107,2,2,0,0,25,2,0,83,2,0,81,103,66,59,2,66,68
687,Meghalaya,2010,02. Kidnapping & Abduction of Women & Girls,6,1,9,0,0,0,10,0,124,97,85,82,37,9,6,0,0,91,6,0,41,17,0,59,75,113,8,6,102,119
688,Mizoram,2010,02. Kidnapping & Abduction of Women & Girls,0,0,0,0,0,0,0,0,0,0,0,0,0,0,0,0,0,0,0,0,0,0,0,0,0,0,0,0,0,0
689,Nagaland,2010,02. Kidnapping & Abduction of Women & Girls,10,1,8,0,4,0,9,0,3,6,6,12,6,8,14,0,0,20,2,0,13,6,1,0,4,5,3,3,2,8
690,Odisha,2010,02. Kidnapping & Abduction of Women & Girls,371,23,811,0,31,120,834,0,879,921,2536,2127,912,811,402,0,0,2938,666,0,1070,1095,41,163,138,3570,0,707,3182,4277
691,Puducherry,2010,02. Kidnapping & Abduction of Women & Girls,3,0,13,0,2,2,13,0,3,4,40,32,14,13,5,0,0,45,5,0,22,26,2,8,4,62,0,7,43,69
692,Punjab,2010,02. Kidnapping & Abduction of Women & Girls,123,120,226,0,47,207,346,0,339,316,911,855,576,226,170,0,0,1081,234,0,646,542,100,609,579,1427,134,334,1219,1761
693,Rajasthan,2010,02. Kidnapping & Abduction of Women & Girls,244,196,815,31,128,1374,1011,0,323,231,4516,4104,2477,815,372,0,0,4919,468,33,1281,1275,251,20,26,8963,0,719,8440,9715
694,Sikkim,2010,02. Kidnapping & Abduction of Women & Girls,1,1,10,1,1,0,11,0,6,11,20,13,6,10,2,0,0,23,1,1,13,10,1,1,2,16,2,2,9,19
695,Tamil Nadu,2010,02. Kidnapping & Abduction of Women & Girls,325,246,619,9,104,316,865,0,945,662,1283,1102,1464,619,429,0,0,1721,683,1,1532,1280,160,991,1165,2655,78,843,2219,3499
696,Tripura,2010,02. Kidnapping & Abduction of Women & Girls,33,14,57,0,3,3,71,0,45,28,199,178,91,57,36,0,0,235,151,0,106,89,3,42,50,152,9,154,217,306
697,Uttar Pradesh,2010,02. Kidnapping & Abduction of Women & Girls,1458,1525,3050,14,1594,565,4575,0,1045,717,7629,7645,5468,3050,3052,0,0,10695,3369,25,11903,6831,3951,1469,2256,14689,4285,7320,15203,22034
698,Uttarakhand,2010,02. Kidnapping & Abduction of Women & Girls,57,91,147,0,36,14,238,0,42,45,558,504,249,147,93,0,0,651,94,0,293,272,55,38,30,963,29,149,840,1112
699,West Bengal,2010,02. Kidnapping & Abduction of Women & Girls,353,435,2069,21,37,66,2504,0,2952,2758,9356,7698,2764,2069,390,0,0,9767,848,48,2254,2545,50,1783,1286,11160,206,898,9561,12106
700,Andaman & Nicobar Islands,2001,03. Dowry Deaths,0,0,0,0,0,0,0,0,0,0,2,2,0,0,0,0,0,2,0,0,0,0,0,0,0,1,0,0,1,1
701,Andhra Pradesh,2001,03. Dowry Deaths,324,10,366,12,87,15,376,0,227,198,1074,1131,420,366,411,0,0,1497,734,2,1054,974,145,414,479,2330,15,879,2237,3211
702,Arunachal Pradesh,2001,03. Dowry Deaths,0,0,0,0,0,0,0,0,0,0,0,0,0,0,0,0,0,0,0,0,0,0,0,0,0,0,0,0,0,0
703,Assam,2001,03. Dowry Deaths,13,0,28,0,8,1,28,0,84,54,94,87,59,28,21,0,0,115,37,0,95,57,18,60,94,197,4,55,195,252
704,Bihar,2001,03. Dowry Deaths,253,107,670,18,146,82,777,0,494,494,2309,2056,859,670,399,0,0,2726,903,64,2899,2362,319,1129,1340,6043,326,1222,4967,7329
705,Chandigarh,2001,03. Dowry Deaths,0,0,2,0,2,0,2,0,1,0,7,7,3,2,2,0,0,9,9,0,7,7,4,0,0,19,0,13,25,32
706,Chhattisgarh,2001,03. Dowry Deaths,31,0,66,0,15,0,66,0,13,9,213,193,70,66,46,0,0,259,82,10,163,177,41,16,2,706,0,123,662,839
707,Dadra & Nagar Haveli,2001,03. Dowry Deaths,0,0,0,0,1,0,0,0,0,0,2,3,0,0,1,0,0,3,0,0,0,0,1,0,0,8,0,1,9,9
708,Daman & Diu,2001,03. Dowry Deaths,0,0,0,0,0,0,0,0,0,0,0,0,0,0,0,0,0,0,0,0,0,0,0,0,0,0,0,0,0,0
709,Delhi,2001,03. Dowry Deaths,32,11,131,0,58,0,142,0,49,78,505,464,113,131,90,0,0,595,51,0,256,304,70,134,75,1638,11,121,1455,1759
710,Goa,2001,03. Dowry Deaths,2,0,2,0,1,1,2,0,0,1,8,9,2,2,3,0,0,11,4,0,4,4,1,0,0,21,0,5,22,26
711,Gujarat,2001,03. Dowry Deaths,21,0,67,4,1,1,67,0,6,7,481,440,67,67,22,0,0,507,58,4,238,255,1,30,13,1662,0,59,1470,1725
712,Haryana,2001,03. Dowry Deaths,250,2,265,9,52,25,267,0,22,29,661,707,285,265,302,0,0,972,716,8,734,748,133,39,25,1638,0,849,1747,2495
713,Himachal Pradesh,2001,03. Dowry Deaths,4,0,6,0,0,3,6,0,4,3,26,24,10,6,4,0,0,30,8,0,15,12,0,5,8,78,0,8,74,86
714,Jammu & Kashmir,2001,03. Dowry Deaths,7,1,16,1,0,0,17,0,1,5,15,7,13,16,7,0,0,23,48,3,40,34,0,3,3,34,6,48,51,85
715,Jharkhand,2001,03. Dowry Deaths,126,16,237,0,50,7,253,0,83,126,410,349,217,237,176,0,0,586,438,0,557,424,235,226,302,1093,57,673,1342,1766
716,Karnataka,2001,03. Dowry Deaths,109,9,216,4,13,9,225,7,66,87,636,559,220,216,122,13,0,762,358,6,422,461,23,237,159,1568,39,381,1494,1955
717,Kerala,2001,03. Dowry Deaths,8,1,27,0,6,0,28,0,20,21,119,106,27,27,14,0,0,133,15,0,55,47,9,21,29,253,0,24,230,277
718,Lakshadweep,2001,03. Dowry Deaths,0,0,0,0,0,0,0,0,0,0,0,0,0,0,0,0,0,0,0,0,0,0,0,0,0,0,0,0,0,0
719,Madhya Pradesh,2001,03. Dowry Deaths,452,9,592,2,165,4,601,0,124,122,1638,1665,609,592,617,0,2,2257,1109,5,1503,1472,402,49,80,4123,0,1511,4167,5639
720,Maharashtra,2001,03. Dowry Deaths,326,3,327,13,34,0,330,0,93,115,3060,3106,308,327,360,0,0,3433,1021,62,1009,1065,97,293,237,7303,0,1118,7418,8483
721,Manipur,2001,03. Dowry Deaths,0,0,0,0,0,0,0,0,0,0,0,0,0,0,0,0,0,0,0,0,0,0,0,0,0,0,0,0,0,0
722,Meghalaya,2001,03. Dowry Deaths,0,0,0,0,0,0,0,0,1,1,0,0,0,0,0,0,0,0,0,0,0,0,0,1,1,5,0,0,5,5
723,Mizoram,2001,03. Dowry Deaths,0,0,0,0,0,0,0,0,0,0,0,0,0,0,0,0,0,0,0,0,0,0,0,0,0,0,0,0,0,0
724,Nagaland,2001,03. Dowry Deaths,0,0,0,0,0,0,0,0,0,0,0,0,0,0,0,0,0,0,0,0,0,0,0,0,0,0,0,0,0,0
725,Odisha,2001,03. Dowry Deaths,148,18,288,0,34,5,306,0,125,142,735,629,294,288,182,0,0,917,367,0,603,602,76,23,19,1337,5,443,1178,1780
726,Puducherry,2001,03. Dowry Deaths,4,0,4,0,2,0,4,0,0,3,4,6,1,4,6,0,0,10,8,0,4,6,8,2,0,7,0,16,17,23
727,Punjab,2001,03. Dowry Deaths,79,7,140,1,50,12,147,0,95,95,335,325,159,140,129,0,0,465,229,9,450,437,119,366,369,1023,10,348,943,1380
728,Rajasthan,2001,03. Dowry Deaths,170,4,306,1,106,94,310,0,45,73,1316,1287,376,306,276,0,0,1593,406,2,722,731,231,20,11,2979,0,637,2887,3618
729,Sikkim,2001,03. Dowry Deaths,0,0,0,0,0,0,0,0,0,0,0,0,0,0,0,0,0,0,0,0,0,0,0,0,0,0,0,0,0,0
730,Tamil Nadu,2001,03. Dowry Deaths,98,6,174,6,44,4,180,3,100,96,557,531,191,174,142,0,0,705,417,118,2266,1969,312,165,305,2158,157,729,1036,3005
731,Tripura,2001,03. Dowry Deaths,7,2,13,0,2,0,15,0,26,25,31,27,16,13,9,0,0,40,13,0,94,51,7,15,35,60,23,20,29,80
732,Uttar Pradesh,2001,03. Dowry Deaths,800,265,1784,101,727,135,2049,0,445,418,7226,7070,2211,1784,1527,0,0,8854,2296,379,6305,5619,2308,904,1223,23187,367,4604,22551,28170
733,Uttarakhand,2001,03. Dowry Deaths,36,3,54,8,24,2,57,0,7,10,133,147,56,54,60,0,0,201,90,31,161,174,68,68,22,489,33,158,504,678
734,West Bengal,2001,03. Dowry Deaths,139,5,279,0,25,0,284,0,269,288,1100,985,265,279,164,0,0,1264,293,0,725,705,63,516,420,2198,116,356,1849,2554
735,Andaman & Nicobar Islands,2002,03. Dowry Deaths,0,0,0,0,0,0,0,0,0,0,2,2,0,0,0,0,0,2,0,0,0,0,0,0,0,1,0,0,1,1
736,Andhra Pradesh,2002,03. Dowry Deaths,360,5,443,7,61,22,448,3,203,227,1089,1074,449,443,421,0,0,1517,745,3,1058,957,140,479,539,2399,41,885,2330,3287
737,Arunachal Pradesh,2002,03. Dowry Deaths,0,0,0,0,0,0,0,0,0,0,0,0,0,0,0,0,0,0,0,0,0,0,0,0,0,0,0,0,0,0
738,Assam,2002,03. Dowry Deaths,10,6,36,0,6,1,42,0,111,84,114,94,70,36,16,0,0,130,33,0,127,77,12,94,131,229,13,45,197,274
739,Bihar,2002,03. Dowry Deaths,245,102,650,1,80,76,752,0,593,494,2633,2309,927,650,325,0,0,2959,666,6,2538,2401,226,1340,1061,7546,416,892,6043,8444
740,Chandigarh,2002,03. Dowry Deaths,2,1,0,0,2,0,1,0,1,1,3,7,1,0,4,0,0,7,9,0,0,0,4,0,0,6,0,13,19,19
741,Chhattisgarh,2002,03. Dowry Deaths,49,3,83,5,22,0,86,1,11,13,220,213,85,83,71,0,0,296,159,13,217,210,92,2,9,652,0,251,706,916
742,Dadra & Nagar Haveli,2002,03. Dowry Deaths,0,0,0,0,0,0,0,0,0,0,2,2,0,0,0,0,0,2,0,0,0,0,0,0,0,8,0,0,8,8
743,Daman & Diu,2002,03. Dowry Deaths,0,0,0,0,0,0,0,0,0,0,0,0,0,0,0,0,0,0,0,0,0,0,0,0,0,0,0,0,0,0
744,Delhi,2002,03. Dowry Deaths,15,5,122,0,12,0,127,0,57,49,600,505,135,122,27,0,0,627,75,0,345,283,36,75,129,1810,8,111,1638,1921
745,Goa,2002,03. Dowry Deaths,0,0,0,0,0,0,0,0,2,0,8,8,2,0,0,0,0,8,0,0,2,0,0,0,2,21,0,0,21,21
746,Gujarat,2002,03. Dowry Deaths,39,5,59,3,3,0,64,0,4,6,495,481,62,59,42,0,0,540,134,7,174,170,6,13,17,1685,0,140,1662,1832
747,Haryana,2002,03. Dowry Deaths,210,2,227,15,59,29,229,0,20,22,604,661,256,227,269,0,0,888,603,37,635,632,148,25,27,1482,1,751,1638,2270
748,Himachal Pradesh,2002,03. Dowry Deaths,0,0,7,0,3,1,7,0,2,4,30,26,6,7,3,0,0,33,4,0,13,17,3,8,4,88,0,7,78,95
749,Jammu & Kashmir,2002,03. Dowry Deaths,4,0,11,0,1,0,11,0,8,1,21,15,18,11,5,0,0,26,7,0,27,25,3,3,5,49,0,10,34,59
750,Jharkhand,2002,03. Dowry Deaths,154,14,238,0,78,8,252,0,94,79,461,455,275,238,232,0,0,693,369,0,632,629,147,304,258,665,49,516,552,1181
751,Karnataka,2002,03. Dowry Deaths,131,6,198,0,13,6,204,19,70,66,690,636,233,198,144,0,0,834,325,69,571,538,32,159,164,1680,28,357,1568,2106
752,Kerala,2002,03. Dowry Deaths,7,1,17,1,2,0,18,0,19,20,126,119,17,17,9,0,0,136,19,1,44,31,4,29,39,260,3,23,253,284
753,Lakshadweep,2002,03. Dowry Deaths,0,0,0,0,0,0,0,0,0,0,0,0,0,0,0,0,0,0,0,0,0,0,0,0,0,0,0,0,0,0
754,Madhya Pradesh,2002,03. Dowry Deaths,391,4,696,7,203,3,700,0,95,124,1733,1638,674,696,594,0,0,2334,980,49,1822,1861,593,80,41,4362,0,1573,4123,5984
755,Maharashtra,2002,03. Dowry Deaths,277,3,312,11,36,2,315,0,79,93,3048,3060,303,312,313,0,0,3372,745,27,1222,1296,97,237,163,7730,0,842,7303,8599
756,Manipur,2002,03. Dowry Deaths,0,0,0,0,0,0,0,0,0,0,0,0,0,0,0,0,0,0,0,0,0,0,0,0,0,0,0,0,0,0
757,Meghalaya,2002,03. Dowry Deaths,0,0,0,0,0,0,0,0,1,1,0,0,0,0,0,0,0,0,0,0,0,0,0,1,1,5,0,0,5,5
758,Mizoram,2002,03. Dowry Deaths,0,0,0,0,0,0,0,0,0,0,0,0,0,0,0,0,0,0,0,0,0,0,0,0,0,0,0,0,0,0
759,Nagaland,2002,03. Dowry Deaths,0,0,0,0,0,0,0,0,0,0,0,0,0,0,0,0,0,0,0,0,0,0,0,0,0,0,0,0,0,0
760,Odisha,2002,03. Dowry Deaths,138,2,231,0,32,5,233,0,135,125,796,735,248,231,170,0,0,966,275,0,602,567,107,19,51,1522,3,382,1337,1904
761,Puducherry,2002,03. Dowry Deaths,2,0,3,0,0,0,3,0,2,0,5,4,5,3,2,0,0,7,7,0,11,7,0,0,4,7,0,7,7,14
762,Punjab,2002,03. Dowry Deaths,68,15,128,2,70,12,143,0,106,95,323,335,166,128,138,0,0,463,217,19,495,489,253,369,337,1023,38,470,1023,1512
763,Rajasthan,2002,03. Dowry Deaths,189,2,298,2,139,87,300,0,57,45,1284,1316,399,298,328,0,0,1614,626,7,582,580,369,11,11,2557,2,995,2979,3559
764,Sikkim,2002,03. Dowry Deaths,0,0,0,0,0,0,0,0,0,0,0,0,0,0,0,0,0,0,0,0,0,0,0,0,0,0,0,0,0,0
765,Tamil Nadu,2002,03. Dowry Deaths,137,6,244,0,76,7,250,2,84,100,588,557,243,244,213,0,0,801,864,0,572,681,751,305,192,1224,4,1615,2158,2839
766,Tripura,2002,03. Dowry Deaths,9,1,18,0,7,0,19,0,23,26,33,31,16,18,16,0,0,49,8,0,13,7,14,35,32,45,9,22,60,67
767,Uttar Pradesh,2002,03. Dowry Deaths,929,184,1818,65,902,136,2002,0,200,445,7148,7226,1893,1818,1831,0,0,9044,2962,192,5673,5844,3115,1223,740,22762,312,6077,23187,29031
768,Uttarakhand,2002,03. Dowry Deaths,19,8,53,0,30,1,61,0,11,7,137,133,66,53,49,0,0,186,56,0,187,138,95,22,51,476,20,151,489,627
769,West Bengal,2002,03. Dowry Deaths,237,35,273,0,33,0,308,0,234,269,1103,1100,273,273,270,0,0,1373,614,0,784,677,60,420,470,2201,57,674,2198,2875
770,Andaman & Nicobar Islands,2003,03. Dowry Deaths,0,0,0,0,0,0,0,0,0,0,2,2,0,0,0,0,0,2,1,0,0,0,0,0,0,0,0,1,1,1
771,Andhra Pradesh,2003,03. Dowry Deaths,336,9,362,3,71,35,371,0,263,203,1041,1089,466,362,407,0,0,1451,830,11,1361,1257,203,539,626,2612,17,1033,2399,3656
772,Arunachal Pradesh,2003,03. Dowry Deaths,0,0,0,0,0,0,0,0,0,0,0,0,0,0,0,0,0,0,0,0,0,0,0,0,0,0,0,0,0,0
773,Assam,2003,03. Dowry Deaths,18,13,32,0,8,1,45,0,125,111,120,114,60,32,26,0,0,146,39,0,113,56,16,131,160,230,28,55,229,285
774,Bihar,2003,03. Dowry Deaths,390,128,595,15,101,57,723,0,722,593,2722,2633,909,595,491,0,0,3228,999,33,2488,1960,298,1061,1311,8176,278,1297,7546,9506
775,Chandigarh,2003,03. Dowry Deaths,0,1,1,0,0,0,2,0,0,1,4,3,1,1,0,0,0,4,0,0,4,4,0,0,0,10,0,0,6,10
776,Chhattisgarh,2003,03. Dowry Deaths,20,0,80,6,20,0,80,0,10,11,254,220,79,80,40,0,0,300,168,9,224,225,39,9,8,669,0,207,660,885
777,Dadra & Nagar Haveli,2003,03. Dowry Deaths,0,0,0,0,0,0,0,0,0,0,2,2,0,0,0,0,0,2,0,0,0,0,0,0,0,8,0,0,8,8
778,Daman & Diu,2003,03. Dowry Deaths,0,0,0,0,0,0,0,0,1,0,0,0,1,0,0,0,0,0,0,0,0,0,0,0,0,0,0,0,0,0
779,Delhi,2003,03. Dowry Deaths,23,7,123,0,9,0,130,0,57,57,691,600,130,123,32,0,0,723,76,0,318,237,29,129,210,1942,0,105,1810,2047
780,Goa,2003,03. Dowry Deaths,1,0,2,0,0,0,2,0,2,2,9,8,2,2,1,0,0,10,1,0,2,4,0,2,0,24,0,1,21,25
781,Gujarat,2003,03. Dowry Deaths,44,2,49,2,4,1,51,0,6,4,494,495,54,49,48,0,0,544,149,9,147,157,11,17,7,1673,0,160,1685,1842
782,Haryana,2003,03. Dowry Deaths,151,1,202,0,60,32,203,0,7,20,595,604,222,202,211,0,0,806,461,0,528,543,164,27,12,1400,0,625,1482,2025
783,Himachal Pradesh,2003,03. Dowry Deaths,7,0,6,0,0,0,6,0,2,2,29,30,6,6,7,0,0,36,23,0,15,17,0,4,2,82,0,23,88,105
784,Jammu & Kashmir,2003,03. Dowry Deaths,9,0,14,0,4,0,14,0,4,8,22,21,10,14,13,0,0,35,20,0,20,24,0,5,1,53,0,20,49,73
785,Jharkhand,2003,03. Dowry Deaths,133,7,225,13,52,3,232,0,121,94,488,461,262,225,185,0,0,686,205,36,578,492,142,258,324,774,20,347,665,1157
786,Karnataka,2003,03. Dowry Deaths,138,8,177,3,24,3,185,12,64,70,702,690,194,177,162,0,0,867,364,73,487,521,54,164,91,1710,39,418,1680,2201
787,Kerala,2003,03. Dowry Deaths,7,1,17,0,4,0,18,1,33,19,132,126,33,17,11,0,0,143,16,0,59,43,14,39,55,273,0,30,260,303
788,Lakshadweep,2003,03. Dowry Deaths,0,0,0,0,0,0,0,0,0,0,0,0,0,0,0,0,0,0,0,0,0,0,0,0,0,0,0,0,0,0
789,Madhya Pradesh,2003,03. Dowry Deaths,446,11,601,25,217,0,612,0,124,88,1637,1724,648,601,663,0,0,2325,1336,2,1812,1792,632,43,63,4588,0,1968,4766,6558
790,Maharashtra,2003,03. Dowry Deaths,319,2,367,10,81,0,369,0,78,79,3005,3048,368,367,400,0,0,3415,1523,40,1459,1404,123,163,217,7448,1,1646,7730,9134
791,Manipur,2003,03. Dowry Deaths,0,0,0,0,0,0,0,0,0,0,0,0,0,0,0,0,0,0,0,0,0,0,0,0,0,0,0,0,0,0
792,Meghalaya,2003,03. Dowry Deaths,0,0,0,0,0,0,0,0,1,1,0,0,0,0,0,0,0,0,0,0,0,0,0,1,1,5,0,0,5,5
793,Mizoram,2003,03. Dowry Deaths,0,0,0,0,0,0,0,0,0,0,0,0,0,0,0,0,0,0,0,0,0,0,0,0,0,0,0,0,0,0
794,Nagaland,2003,03. Dowry Deaths,0,0,0,0,0,0,0,0,0,0,0,0,0,0,0,0,0,0,0,0,0,0,0,0,0,0,0,0,0,0
795,Odisha,2003,03. Dowry Deaths,138,4,286,0,48,12,290,0,112,135,896,796,279,286,186,0,0,1082,515,0,686,686,114,51,51,1579,0,629,1522,2208
796,Puducherry,2003,03. Dowry Deaths,0,0,1,0,0,0,1,0,2,2,6,5,1,1,0,0,0,6,0,0,0,3,0,4,1,10,0,0,7,10
797,Punjab,2003,03. Dowry Deaths,80,2,125,5,101,11,127,0,78,106,262,323,110,125,181,0,0,448,179,29,288,317,285,337,280,847,28,464,1023,1340
798,Rajasthan,2003,03. Dowry Deaths,169,6,270,3,121,90,276,0,80,57,1261,1284,389,270,290,0,0,1554,346,9,582,575,278,11,18,2499,0,624,2557,3132
799,Sikkim,2003,03. Dowry Deaths,0,0,0,0,0,0,0,0,0,0,0,0,0,0,0,0,0,0,0,0,0,0,0,0,0,0,0,0,0,0
800,Tamil Nadu,2003,03. Dowry Deaths,178,7,217,1,66,2,224,0,82,88,570,598,220,217,244,0,0,815,396,0,484,528,139,212,165,1191,3,535,1198,1726
801,Tripura,2003,03. Dowry Deaths,5,0,17,0,7,0,17,0,26,23,38,33,20,17,12,0,0,50,9,0,41,22,9,32,42,49,9,18,45,67
802,Uttar Pradesh,2003,03. Dowry Deaths,759,93,1111,46,649,63,1204,0,255,200,6805,7148,1322,1111,1408,0,0,8259,2263,156,3792,3734,2372,740,703,21705,95,4635,22762,26496
803,Uttarakhand,2003,03. Dowry Deaths,13,9,79,0,25,1,88,0,15,11,178,137,93,79,38,0,0,216,32,0,234,255,70,51,17,629,13,102,476,731
804,West Bengal,2003,03. Dowry Deaths,182,7,313,0,36,1,320,1,241,234,1198,1103,329,313,218,0,0,1416,564,0,914,683,128,470,603,2192,98,692,2201,2884
805,Andaman & Nicobar Islands,2004,03. Dowry Deaths,0,0,0,0,1,0,0,0,0,0,1,2,0,0,1,0,0,2,0,0,0,0,1,0,0,0,0,1,1,1
806,Andhra Pradesh,2004,03. Dowry Deaths,341,26,417,2,66,37,443,0,295,263,1049,1041,512,417,407,0,0,1458,891,47,1102,1123,194,626,565,2603,40,1085,2612,3735
807,Arunachal Pradesh,2004,03. Dowry Deaths,0,0,0,0,0,0,0,0,0,0,0,0,0,0,0,0,0,0,0,0,0,0,0,0,0,0,0,0,0,0
808,Assam,2004,03. Dowry Deaths,18,10,63,0,14,5,73,0,121,125,151,120,74,63,32,0,0,183,54,0,161,125,30,160,172,271,24,84,230,355
809,Bihar,2004,03. Dowry Deaths,351,68,490,2,88,65,558,0,1128,722,2771,2722,1029,490,439,0,0,3212,1024,28,2317,1679,171,1311,1405,8632,544,1195,8176,9855
810,Chandigarh,2004,03. Dowry Deaths,2,0,4,0,0,0,4,0,2,0,6,4,6,4,2,0,0,8,7,0,13,9,0,0,4,12,0,7,10,19
811,Chhattisgarh,2004,03. Dowry Deaths,57,1,78,1,32,0,79,0,2,10,242,254,71,78,89,0,0,332,142,29,220,227,83,8,1,642,0,225,669,896
812,Dadra & Nagar Haveli,2004,03. Dowry Deaths,0,0,0,0,0,0,0,0,0,0,2,2,0,0,0,0,0,2,0,0,0,0,0,0,0,8,0,0,8,8
813,Daman & Diu,2004,03. Dowry Deaths,0,0,0,0,0,0,0,0,1,1,0,0,0,0,0,0,0,0,0,0,0,0,0,0,0,0,0,0,0,0
814,Delhi,2004,03. Dowry Deaths,43,0,118,0,29,0,118,0,65,57,737,691,126,118,72,0,0,809,86,0,298,327,105,210,181,2078,0,191,1942,2269
815,Goa,2004,03. Dowry Deaths,4,1,0,0,0,0,1,0,3,2,5,9,2,0,4,0,0,9,9,0,8,0,0,0,8,15,0,9,24,24
816,Gujarat,2004,03. Dowry Deaths,49,1,57,1,5,1,58,0,5,6,496,494,58,57,54,0,0,551,135,0,122,120,5,7,9,1653,0,140,1673,1793
817,Haryana,2004,03. Dowry Deaths,220,4,209,0,63,21,213,0,24,7,521,595,251,209,283,0,0,804,463,0,563,535,143,12,40,1329,0,606,1400,1935
818,Himachal Pradesh,2004,03. Dowry Deaths,6,0,7,0,1,1,7,0,2,2,29,29,8,7,7,0,0,36,15,0,25,25,2,2,2,90,0,17,82,107
819,Jammu & Kashmir,2004,03. Dowry Deaths,11,0,9,0,2,0,9,0,4,4,18,22,9,9,13,0,0,31,20,0,24,24,2,1,1,55,0,22,53,77
820,Jharkhand,2004,03. Dowry Deaths,133,7,225,13,52,3,232,0,161,121,515,488,275,225,185,0,0,713,205,36,578,492,142,324,390,883,20,347,774,1266
821,Karnataka,2004,03. Dowry Deaths,198,15,214,1,35,9,229,15,68,64,682,702,259,214,233,0,2,916,484,2,553,560,77,91,66,1707,18,561,1710,2270
822,Kerala,2004,03. Dowry Deaths,8,1,39,0,5,2,40,0,22,33,158,132,31,39,13,0,0,171,15,0,53,91,13,55,17,336,0,28,273,364
823,Lakshadweep,2004,03. Dowry Deaths,0,0,0,0,0,0,0,0,0,0,0,0,0,0,0,0,0,0,0,0,0,0,0,0,0,0,0,0,0,0
824,Madhya Pradesh,2004,03. Dowry Deaths,505,7,753,5,260,1,760,0,114,124,1620,1637,751,753,765,0,0,2390,1270,8,2257,2255,668,63,65,4897,0,1938,4588,6843
825,Maharashtra,2004,03. Dowry Deaths,285,0,322,1,36,0,322,0,70,78,3005,3005,314,322,321,0,0,3327,846,1,1235,1270,99,217,182,7772,0,945,7448,8718
826,Manipur,2004,03. Dowry Deaths,0,0,0,0,0,0,0,0,0,0,0,0,0,0,0,0,0,0,0,0,0,0,0,0,0,0,0,0,0,0
827,Meghalaya,2004,03. Dowry Deaths,0,0,0,0,0,0,0,0,3,1,0,0,2,0,0,0,0,0,0,0,3,1,0,1,3,6,0,0,5,6
828,Mizoram,2004,03. Dowry Deaths,0,0,0,0,0,0,0,0,0,0,0,0,0,0,0,0,0,0,0,0,0,0,0,0,0,0,0,0,0,0
829,Nagaland,2004,03. Dowry Deaths,0,0,0,0,0,0,0,0,0,0,0,0,0,0,0,0,0,0,0,0,0,0,0,0,0,0,0,0,0,0
830,Odisha,2004,03. Dowry Deaths,202,2,298,0,44,15,300,0,116,112,948,896,319,298,246,0,0,1194,489,0,932,849,121,51,134,1818,0,610,1579,2428
831,Puducherry,2004,03. Dowry Deaths,1,0,3,0,0,0,3,0,5,2,8,6,6,3,1,0,0,9,1,0,9,5,0,1,5,14,0,1,10,15
832,Punjab,2004,03. Dowry Deaths,45,5,104,3,47,10,109,0,72,78,271,262,113,104,92,0,0,366,150,7,345,338,141,280,265,887,22,291,847,1185
833,Rajasthan,2004,03. Dowry Deaths,165,1,320,6,126,68,321,0,70,80,1284,1261,379,320,291,0,0,1581,340,15,680,689,270,18,9,2563,0,610,2499,3188
834,Sikkim,2004,03. Dowry Deaths,0,0,0,0,0,0,0,0,0,0,0,0,0,0,0,0,0,0,0,0,0,0,0,0,0,0,0,0,0,0
835,Tamil Nadu,2004,03. Dowry Deaths,134,10,213,0,42,0,223,0,84,82,607,570,225,213,176,0,0,783,340,2,514,545,116,165,134,1278,0,456,1191,1736
836,Tripura,2004,03. Dowry Deaths,8,5,22,0,1,0,27,0,19,26,51,38,20,22,9,0,0,60,17,0,28,33,2,42,26,63,11,19,49,82
837,Uttar Pradesh,2004,03. Dowry Deaths,707,172,1393,69,727,118,1565,0,280,255,6695,6805,1708,1393,1434,0,0,8198,2271,237,4836,4480,2262,703,807,21415,252,4533,21705,26185
838,Uttarakhand,2004,03. Dowry Deaths,13,7,65,0,30,9,72,0,16,15,200,178,82,65,43,0,0,243,46,0,267,204,119,17,50,668,30,165,629,833
839,West Bengal,2004,03. Dowry Deaths,165,4,344,0,29,0,348,0,289,241,1348,1198,396,344,194,0,0,1542,583,0,976,802,69,603,629,2342,148,652,2192,2994
840,Andaman & Nicobar Islands,2005,03. Dowry Deaths,0,0,0,0,0,0,0,0,0,0,1,1,0,0,0,0,0,1,0,0,0,0,0,0,0,0,0,0,0,0
841,Andhra Pradesh,2005,03. Dowry Deaths,429,7,473,3,118,20,480,0,238,295,972,1049,443,473,547,0,0,1522,1033,11,1280,1329,202,565,479,2686,37,1235,2603,3932
842,Arunachal Pradesh,2005,03. Dowry Deaths,0,0,0,0,0,0,0,0,0,0,0,0,0,0,0,0,0,0,0,0,0,0,0,0,0,0,0,0,0,0
843,Assam,2005,03. Dowry Deaths,23,12,61,0,15,6,73,0,141,121,174,151,99,61,38,0,0,212,53,0,174,99,31,172,231,286,16,84,271,370
844,Bihar,2005,03. Dowry Deaths,391,53,680,3,110,46,733,0,1363,1128,2947,2771,1014,680,501,0,0,3451,1136,12,2323,2162,223,1405,1412,9423,154,1359,8632,10794
845,Chandigarh,2005,03. Dowry Deaths,6,0,4,0,0,0,4,0,1,2,4,6,3,4,6,0,0,10,12,0,6,9,0,4,1,9,0,12,12,21
846,Chhattisgarh,2005,03. Dowry Deaths,36,1,91,3,26,0,92,0,10,2,268,242,100,91,62,0,0,333,150,38,296,289,60,1,8,683,0,210,642,931
847,Dadra & Nagar Haveli,2005,03. Dowry Deaths,1,0,0,0,0,0,0,0,0,0,1,2,0,0,1,0,0,2,5,0,0,0,0,0,0,3,0,5,8,8
848,Daman & Diu,2005,03. Dowry Deaths,0,0,1,0,0,0,1,0,1,1,2,1,1,1,0,0,0,2,0,0,0,0,0,0,0,0,0,0,0,0
849,Delhi,2005,03. Dowry Deaths,85,2,95,0,40,1,97,0,81,65,707,737,114,95,125,0,0,832,186,0,267,227,158,181,216,1961,5,344,2078,2305
850,Goa,2005,03. Dowry Deaths,2,0,3,0,0,0,3,0,2,3,6,5,2,3,2,0,0,8,4,0,2,9,0,8,1,20,0,4,15,24
851,Gujarat,2005,03. Dowry Deaths,55,0,48,0,10,0,48,0,5,5,479,496,48,48,65,0,0,544,130,0,136,139,16,9,6,1646,0,146,1653,1792
852,Haryana,2005,03. Dowry Deaths,196,3,185,0,52,31,188,0,17,24,458,521,212,185,248,0,0,706,484,0,481,502,141,40,19,1206,0,625,1329,1831
853,Himachal Pradesh,2005,03. Dowry Deaths,3,0,1,0,1,1,1,0,2,2,26,29,2,1,4,0,0,30,11,0,6,3,1,2,5,81,0,12,90,93
854,Jammu & Kashmir,2005,03. Dowry Deaths,1,0,7,0,1,0,7,0,2,4,23,18,5,7,2,0,0,25,2,0,26,23,1,1,3,75,1,3,55,78
855,Jharkhand,2005,03. Dowry Deaths,15,18,166,10,71,2,184,0,232,161,585,515,257,166,86,0,0,681,425,58,503,421,118,390,396,703,76,543,883,1304
856,Karnataka,2005,03. Dowry Deaths,261,8,233,0,63,2,241,9,77,68,591,682,261,233,324,0,0,915,614,0,578,538,129,66,92,1502,14,743,1707,2245
857,Kerala,2005,03. Dowry Deaths,24,0,18,0,10,0,18,0,25,22,142,158,21,18,34,0,0,176,38,4,31,19,18,17,29,295,0,56,336,355
858,Lakshadweep,2005,03. Dowry Deaths,0,0,0,0,0,0,0,0,0,0,0,0,0,0,0,0,0,0,0,0,0,0,0,0,0,0,0,0,0,0
859,Madhya Pradesh,2005,03. Dowry Deaths,476,7,715,19,262,4,722,0,127,114,1578,1620,739,715,738,0,0,2335,1536,21,1992,2023,716,65,34,4647,0,2252,4897,6920
860,Maharashtra,2005,03. Dowry Deaths,266,2,336,2,34,1,338,0,72,70,3039,3005,341,336,300,0,0,3341,792,2,1379,1315,72,182,246,8221,0,864,7772,9087
861,Manipur,2005,03. Dowry Deaths,0,0,0,0,0,0,0,0,0,0,0,0,0,0,0,0,0,0,0,0,0,0,0,0,0,0,0,0,0,0
862,Meghalaya,2005,03. Dowry Deaths,0,0,0,0,0,0,0,0,4,3,0,0,1,0,0,0,0,0,0,0,1,0,0,3,3,6,1,0,6,6
863,Mizoram,2005,03. Dowry Deaths,0,0,4,0,2,0,4,0,0,0,2,0,4,4,2,0,0,4,0,0,0,0,0,0,0,0,0,0,0,0
864,Nagaland,2005,03. Dowry Deaths,0,0,0,0,0,0,0,0,0,0,0,0,0,0,0,0,0,0,0,0,0,0,0,0,0,0,0,0,0,0
865,Odisha,2005,03. Dowry Deaths,175,4,268,0,35,10,272,0,168,116,1006,948,334,268,210,0,0,1216,445,0,708,714,72,134,128,2015,0,517,1818,2532
866,Puducherry,2005,03. Dowry Deaths,0,0,2,0,0,0,2,0,7,5,10,8,4,2,0,0,0,10,0,0,4,5,0,5,4,19,0,0,14,19
867,Punjab,2005,03. Dowry Deaths,37,4,89,0,28,12,93,0,66,72,295,271,99,89,65,0,0,360,85,7,246,248,89,265,252,954,11,174,887,1135
868,Rajasthan,2005,03. Dowry Deaths,143,3,281,4,119,87,284,0,60,70,1299,1284,361,281,262,0,0,1565,297,22,560,559,256,9,9,2547,1,553,2563,3122
869,Sikkim,2005,03. Dowry Deaths,0,0,0,0,0,0,0,0,0,0,0,0,0,0,0,0,0,0,0,0,0,0,0,0,0,0,0,0,0,0
870,Tamil Nadu,2005,03. Dowry Deaths,171,2,212,0,71,5,214,0,80,84,571,607,215,212,242,6,0,813,388,0,492,507,152,134,119,1245,0,540,1278,1785
871,Tripura,2005,03. Dowry Deaths,6,9,28,0,7,0,37,0,16,19,66,51,34,28,13,0,0,79,20,0,43,35,4,26,19,74,15,24,63,98
872,Uttar Pradesh,2005,03. Dowry Deaths,621,127,1367,102,678,82,1494,0,268,280,6661,6695,1564,1367,1299,0,0,8062,1951,272,4523,4233,1900,807,910,21525,187,3851,21415,25648
873,Uttarakhand,2005,03. Dowry Deaths,29,14,48,0,14,2,62,0,15,16,205,200,63,48,43,0,0,248,84,0,160,135,43,50,48,676,27,127,668,803
874,West Bengal,2005,03. Dowry Deaths,267,15,389,0,94,0,404,0,331,289,1376,1348,446,389,361,0,0,1737,564,0,956,805,173,629,658,2410,122,737,2342,3147
875,Andaman & Nicobar Islands,2006,03. Dowry Deaths,0,0,0,0,0,0,0,0,0,0,1,1,0,0,0,0,0,1,0,0,0,0,0,0,0,0,0,0,0,0
876,Andhra Pradesh,2006,03. Dowry Deaths,280,26,426,1,73,25,452,0,280,238,1044,972,519,426,353,0,0,1398,1100,16,1274,1062,248,479,635,2384,56,1348,2686,3748
877,Arunachal Pradesh,2006,03. Dowry Deaths,0,0,0,0,0,0,0,0,1,0,0,0,1,0,0,0,0,0,0,0,0,0,0,0,0,0,0,0,0,0
878,Assam,2006,03. Dowry Deaths,21,16,74,2,30,3,90,0,153,141,195,174,105,74,51,0,0,248,45,0,201,144,33,231,248,352,40,78,286,430
879,Bihar,2006,03. Dowry Deaths,512,80,749,1,138,38,829,0,1684,1363,3045,2947,1188,749,650,0,0,3696,1568,4,2674,2255,355,1412,1666,9751,165,1923,9423,11678
880,Chandigarh,2006,03. Dowry Deaths,3,0,9,0,0,0,9,0,2,1,10,4,10,9,3,0,0,13,7,0,30,24,0,1,7,26,0,7,9,33
881,Chhattisgarh,2006,03. Dowry Deaths,48,0,99,4,23,0,99,0,14,10,292,268,103,99,71,0,0,367,184,3,273,267,69,8,14,694,0,253,683,950
882,Dadra & Nagar Haveli,2006,03. Dowry Deaths,0,0,0,0,0,0,0,0,1,0,1,1,1,0,0,0,0,1,0,0,1,0,0,0,1,3,0,0,3,3
883,Daman & Diu,2006,03. Dowry Deaths,0,0,1,0,0,0,1,0,0,1,2,1,0,1,0,0,0,2,0,0,1,1,0,0,0,1,0,0,0,1
884,Delhi,2006,03. Dowry Deaths,73,9,134,0,47,4,143,0,71,81,721,707,137,134,120,0,0,841,103,0,320,309,192,216,221,1975,6,295,1961,2270
885,Goa,2006,03. Dowry Deaths,2,0,1,0,0,0,1,0,1,2,5,6,0,1,2,0,0,7,8,0,0,1,0,1,0,13,0,8,20,21
886,Gujarat,2006,03. Dowry Deaths,31,4,43,1,3,1,47,1,6,5,487,479,50,43,34,0,0,522,105,0,150,133,5,6,23,1669,0,110,1646,1779
887,Haryana,2006,03. Dowry Deaths,129,1,215,2,69,22,216,0,34,17,473,458,255,215,198,0,0,673,340,7,533,514,169,19,38,1204,0,509,1206,1720
888,Himachal Pradesh,2006,03. Dowry Deaths,4,0,4,0,1,0,4,0,1,2,25,26,3,4,5,0,0,30,12,0,12,13,1,5,4,81,0,13,81,94
889,Jammu & Kashmir,2006,03. Dowry Deaths,2,0,8,0,0,1,8,0,3,2,29,23,10,8,2,0,0,31,4,0,12,13,0,3,1,84,1,4,75,88
890,Jharkhand,2006,03. Dowry Deaths,195,25,170,9,60,0,195,0,318,232,491,585,281,170,255,0,0,755,424,70,557,474,140,396,453,543,26,564,703,1177
891,Karnataka,2006,03. Dowry Deaths,242,8,213,1,41,7,221,11,80,77,520,591,244,213,283,0,2,804,541,3,587,521,81,92,150,1398,8,622,1502,2023
892,Kerala,2006,03. Dowry Deaths,19,2,21,0,6,1,23,0,26,25,138,142,25,21,25,0,0,163,42,0,39,37,13,29,31,277,0,55,295,332
893,Lakshadweep,2006,03. Dowry Deaths,0,0,0,0,0,0,0,0,0,0,0,0,0,0,0,0,0,0,0,0,0,0,0,0,0,0,0,0,0,0
894,Madhya Pradesh,2006,03. Dowry Deaths,398,7,735,7,280,2,742,0,147,127,1628,1578,764,735,678,0,0,2313,1042,18,2203,2187,663,34,50,5111,0,1705,4647,6834
895,Maharashtra,2006,03. Dowry Deaths,245,0,374,0,27,0,374,0,85,72,3141,3039,387,374,272,0,0,3413,760,0,1348,1266,76,246,328,8651,0,836,8221,9487
896,Manipur,2006,03. Dowry Deaths,0,0,0,0,0,0,0,0,0,0,0,0,0,0,0,0,0,0,0,0,0,0,0,0,0,0,0,0,0,0
897,Meghalaya,2006,03. Dowry Deaths,0,1,3,0,0,0,4,0,6,4,3,0,6,3,0,0,0,3,0,0,0,2,0,3,1,8,0,0,6,8
898,Mizoram,2006,03. Dowry Deaths,0,0,0,2,0,0,0,0,0,0,0,2,0,0,0,0,0,2,0,0,0,0,0,0,0,0,0,0,0,0
899,Nagaland,2006,03. Dowry Deaths,0,0,0,0,0,0,0,0,0,0,0,0,0,0,0,0,0,0,0,0,0,0,0,0,0,0,0,0,0,0
900,Odisha,2006,03. Dowry Deaths,171,3,317,0,44,5,320,0,300,168,1108,1006,457,317,215,0,0,1323,424,0,969,990,123,128,107,2458,0,547,2015,3005
901,Puducherry,2006,03. Dowry Deaths,2,0,7,0,2,0,7,0,3,7,13,10,3,7,4,0,0,17,4,0,7,9,6,4,2,18,0,10,19,28
902,Punjab,2006,03. Dowry Deaths,40,4,106,0,31,6,110,0,80,66,330,295,130,106,71,0,0,401,114,0,331,259,106,252,318,993,6,220,954,1213
903,Rajasthan,2006,03. Dowry Deaths,163,1,327,7,127,87,328,0,39,60,1329,1299,394,327,290,0,0,1626,430,36,665,672,357,9,2,2396,0,787,2547,3219
904,Sikkim,2006,03. Dowry Deaths,0,0,0,0,0,0,0,0,0,0,0,0,0,0,0,0,0,0,0,0,0,0,0,0,0,0,0,0,0,0
905,Tamil Nadu,2006,03. Dowry Deaths,116,4,169,0,48,1,173,0,93,80,576,571,187,169,164,0,0,740,446,0,457,403,98,119,172,1104,1,544,1245,1648
906,Tripura,2006,03. Dowry Deaths,9,10,22,0,10,0,32,0,19,16,69,66,35,22,19,0,0,88,4,0,25,11,8,19,16,73,17,12,74,85
907,Uttar Pradesh,2006,03. Dowry Deaths,671,175,1464,64,695,88,1639,0,339,268,6695,6661,1798,1464,1366,0,0,8125,2155,191,5280,4944,2206,910,897,21917,349,4361,21525,26469
908,Uttarakhand,2006,03. Dowry Deaths,15,9,51,1,18,5,60,0,30,15,222,205,80,51,33,0,0,256,103,18,227,187,66,48,73,676,15,169,676,863
909,West Bengal,2006,03. Dowry Deaths,207,15,478,0,57,1,493,0,282,331,1590,1376,445,478,264,0,0,1854,437,0,1058,1039,129,658,622,2883,55,566,2410,3449
910,Andaman & Nicobar Islands,2007,03. Dowry Deaths,0,0,0,0,0,0,0,0,1,0,1,1,1,0,0,0,0,1,0,0,2,0,0,0,2,0,0,0,0,0
911,Andhra Pradesh,2007,03. Dowry Deaths,445,9,573,14,97,38,582,0,273,280,1061,1044,613,573,542,0,0,1617,860,2,1562,1450,252,635,733,2720,14,1112,2384,3834
912,Arunachal Pradesh,2007,03. Dowry Deaths,0,1,0,0,0,0,1,0,0,1,0,0,0,0,0,0,0,0,0,0,0,0,0,0,0,0,0,0,0,0
913,Assam,2007,03. Dowry Deaths,39,19,72,0,20,1,91,0,161,153,208,195,100,72,59,0,0,267,64,2,172,139,29,248,252,396,29,93,352,491
914,Bihar,2007,03. Dowry Deaths,475,139,1028,5,167,117,1167,0,1572,1684,3426,3045,1172,1028,642,0,0,4073,1438,15,3265,2512,375,1666,2239,10435,180,1813,9751,12263
915,Chandigarh,2007,03. Dowry Deaths,1,0,2,0,3,0,2,0,1,2,8,10,1,2,4,0,0,12,4,0,3,7,8,7,3,21,0,12,26,33
916,Chhattisgarh,2007,03. Dowry Deaths,65,1,106,1,23,1,107,0,6,14,309,292,100,106,88,0,0,398,129,3,247,241,131,14,20,672,0,260,694,935
917,Dadra & Nagar Haveli,2007,03. Dowry Deaths,0,0,0,0,0,0,0,0,1,1,1,1,0,0,0,0,0,1,0,0,0,0,0,1,1,3,0,0,3,3
918,Daman & Diu,2007,03. Dowry Deaths,0,0,1,0,0,0,1,0,0,0,3,2,1,1,0,0,0,3,0,0,3,3,0,0,0,4,0,0,1,4
919,Delhi,2007,03. Dowry Deaths,83,7,123,0,56,1,130,0,78,71,705,721,138,123,139,0,0,844,122,0,313,272,211,221,258,1914,4,333,1975,2247
920,Goa,2007,03. Dowry Deaths,0,0,0,0,0,0,0,0,3,1,5,5,2,0,0,0,0,5,0,0,8,0,0,0,8,13,0,0,13,13
921,Gujarat,2007,03. Dowry Deaths,27,4,38,1,4,0,42,1,5,6,493,487,42,38,31,0,0,525,141,7,121,139,11,23,5,1649,0,152,1669,1808
922,Haryana,2007,03. Dowry Deaths,159,1,238,2,62,36,239,0,28,34,488,473,269,238,221,0,0,711,393,7,572,581,160,38,29,1225,0,553,1204,1785
923,Himachal Pradesh,2007,03. Dowry Deaths,3,0,5,0,1,1,5,0,3,1,26,25,8,5,4,0,0,30,11,0,31,29,3,4,6,96,0,14,81,110
924,Jammu & Kashmir,2007,03. Dowry Deaths,4,1,7,0,0,1,8,0,3,3,32,29,9,7,4,0,0,36,24,0,21,21,0,1,1,81,0,24,84,105
925,Jharkhand,2007,03. Dowry Deaths,194,49,223,3,92,16,272,0,333,318,425,491,303,223,286,0,0,714,364,11,559,518,131,453,426,555,68,495,543,1061
926,Karnataka,2007,03. Dowry Deaths,179,15,189,2,27,6,204,13,108,80,501,520,251,189,206,0,0,709,473,12,582,620,66,150,110,1467,2,539,1398,2018
927,Kerala,2007,03. Dowry Deaths,24,1,27,0,4,1,28,0,24,26,137,138,27,27,28,0,0,165,41,0,40,52,8,31,19,280,0,49,277,329
928,Lakshadweep,2007,03. Dowry Deaths,0,0,0,0,0,0,0,0,0,0,0,0,0,0,0,0,0,0,0,0,0,0,0,0,0,0,0,0,0,0
929,Madhya Pradesh,2007,03. Dowry Deaths,412,8,738,7,279,3,746,0,140,147,1668,1628,742,738,691,0,0,2366,1362,24,2127,2120,727,50,57,5118,0,2089,5111,7231
930,Maharashtra,2007,03. Dowry Deaths,256,1,376,2,30,1,377,1,142,85,3229,3141,436,376,286,0,0,3517,852,3,1349,1286,89,328,388,8993,3,941,8651,9937
931,Manipur,2007,03. Dowry Deaths,0,0,0,0,0,0,0,0,0,0,0,0,0,0,0,0,0,0,0,0,0,0,0,0,0,0,0,0,0,0
932,Meghalaya,2007,03. Dowry Deaths,0,2,1,0,0,0,3,0,5,6,4,3,2,1,0,0,0,4,0,0,4,1,0,1,4,9,0,0,8,9
933,Mizoram,2007,03. Dowry Deaths,0,0,0,0,0,0,0,0,0,0,0,0,0,0,0,0,0,0,0,0,0,0,0,0,0,0,0,0,0,0
934,Nagaland,2007,03. Dowry Deaths,0,0,0,0,0,0,0,0,0,0,0,0,0,0,0,0,0,0,0,0,0,0,0,0,0,0,0,0,0,0
935,Odisha,2007,03. Dowry Deaths,143,8,338,0,31,16,346,0,399,300,1272,1108,461,338,174,0,0,1446,579,0,958,866,175,107,185,2570,14,754,2458,3324
936,Puducherry,2007,03. Dowry Deaths,3,0,3,0,1,0,3,0,2,3,12,13,2,3,4,0,0,16,4,0,8,7,3,2,3,18,0,7,18,25
937,Punjab,2007,03. Dowry Deaths,54,5,119,0,43,14,124,0,75,80,352,330,133,119,97,0,0,449,191,0,316,291,141,318,325,952,18,332,993,1284
938,Rajasthan,2007,03. Dowry Deaths,126,2,330,3,118,94,332,0,52,39,1412,1329,439,330,244,0,0,1659,248,8,683,674,215,2,11,2599,0,463,2396,3070
939,Sikkim,2007,03. Dowry Deaths,0,0,0,0,0,0,0,0,0,0,0,0,0,0,0,0,0,0,0,0,0,0,0,0,0,0,0,0,0,0
940,Tamil Nadu,2007,03. Dowry Deaths,154,0,189,0,64,1,189,0,111,93,547,576,208,189,218,0,0,765,313,0,503,457,117,172,218,1131,0,430,1104,1561
941,Tripura,2007,03. Dowry Deaths,20,1,21,0,11,0,22,0,33,19,59,69,36,21,31,0,0,90,28,0,42,40,23,16,17,62,1,51,73,113
942,Uttar Pradesh,2007,03. Dowry Deaths,733,250,1768,44,739,154,2018,0,243,339,6947,6695,2076,1768,1472,0,0,8463,2628,188,7310,6018,2551,897,907,22568,1282,5179,21917,27935
943,Uttarakhand,2007,03. Dowry Deaths,43,4,74,0,28,2,78,0,20,30,225,222,70,74,71,0,0,296,91,0,244,225,81,73,70,729,22,172,676,901
944,West Bengal,2007,03. Dowry Deaths,309,20,459,0,46,0,479,0,254,282,1694,1590,451,459,355,0,0,2049,876,13,1068,1148,73,622,495,3069,47,949,2883,4031
945,Andaman & Nicobar Islands,2008,03. Dowry Deaths,0,0,2,0,0,0,2,0,1,1,3,1,2,2,0,0,0,3,0,0,3,3,0,2,2,3,0,0,0,3
946,Andhra Pradesh,2008,03. Dowry Deaths,382,29,471,0,67,36,500,0,293,273,1083,1061,556,471,449,0,0,1532,903,4,1585,1619,179,733,661,3253,38,1082,2720,4339
947,Arunachal Pradesh,2008,03. Dowry Deaths,0,0,0,0,0,0,0,0,0,0,0,0,0,0,0,0,0,0,0,0,0,0,0,0,0,0,0,0,0,0
948,Assam,2008,03. Dowry Deaths,24,8,83,0,20,1,91,0,172,161,247,208,103,83,44,0,0,291,70,0,159,143,32,252,257,437,11,102,396,539
949,Bihar,2008,03. Dowry Deaths,512,131,783,5,177,122,914,0,1746,1572,3515,3426,1210,783,689,0,0,4209,1644,15,2605,2561,381,2239,2245,10956,38,2025,10435,12996
950,Chandigarh,2008,03. Dowry Deaths,2,0,3,0,1,0,3,0,1,1,8,8,3,3,3,0,0,11,5,0,7,7,1,3,3,22,0,6,21,28
951,Chhattisgarh,2008,03. Dowry Deaths,51,0,92,1,25,0,92,0,20,6,324,309,106,92,76,0,0,401,149,0,254,250,89,20,23,684,1,238,672,922
952,Dadra & Nagar Haveli,2008,03. Dowry Deaths,0,0,0,0,0,0,0,0,1,1,1,1,0,0,0,0,0,1,0,0,0,0,0,1,1,3,0,0,3,3
953,Daman & Diu,2008,03. Dowry Deaths,2,0,0,0,0,0,0,0,0,0,1,3,0,0,2,0,0,3,4,0,0,0,0,0,0,0,0,4,4,4
954,Delhi,2008,03. Dowry Deaths,13,1,115,0,13,0,116,0,89,78,794,705,129,115,26,0,2,820,56,0,230,297,75,258,191,2080,0,131,1914,2211
955,Goa,2008,03. Dowry Deaths,0,0,3,0,0,0,3,0,2,3,8,5,2,3,0,0,0,8,0,0,2,10,0,8,0,23,0,0,13,23
956,Gujarat,2008,03. Dowry Deaths,14,1,27,2,1,0,28,2,2,5,503,493,27,27,15,0,0,520,64,3,79,76,1,5,8,1657,0,65,1649,1725
957,Haryana,2008,03. Dowry Deaths,169,7,258,5,69,32,265,0,33,28,503,488,302,258,238,0,0,746,392,15,622,603,169,29,48,1252,0,561,1225,1828
958,Himachal Pradesh,2008,03. Dowry Deaths,5,0,5,0,3,0,5,0,1,3,23,26,3,5,8,0,0,31,20,0,8,12,7,6,2,81,0,27,96,108
959,Jammu & Kashmir,2008,03. Dowry Deaths,1,0,15,1,0,1,15,0,8,3,45,32,21,15,1,0,0,47,3,0,25,24,0,1,2,102,0,3,81,105
960,Jharkhand,2008,03. Dowry Deaths,154,24,219,16,55,4,243,0,352,333,419,425,266,219,209,0,0,644,231,23,570,538,96,426,438,743,20,327,555,1093
961,Karnataka,2008,03. Dowry Deaths,161,7,244,2,24,5,251,19,91,108,558,501,259,244,185,0,1,745,377,4,698,669,66,110,133,1689,6,443,1467,2136
962,Kerala,2008,03. Dowry Deaths,9,1,25,0,2,1,26,0,28,24,151,137,31,25,11,0,0,162,10,0,35,25,3,19,29,292,0,13,280,305
963,Lakshadweep,2008,03. Dowry Deaths,0,0,0,0,0,0,0,0,0,0,0,0,0,0,0,0,0,0,0,0,0,0,0,0,0,0,0,0,0,0
964,Madhya Pradesh,2008,03. Dowry Deaths,398,5,790,6,295,0,795,0,150,140,1759,1668,805,790,693,0,0,2458,1203,12,2302,2292,765,57,67,5430,0,1968,5118,7410
965,Maharashtra,2008,03. Dowry Deaths,253,4,397,1,24,2,401,1,128,142,3348,3229,390,397,277,0,0,3626,811,2,1464,1408,73,388,438,9515,6,884,8993,10401
966,Manipur,2008,03. Dowry Deaths,0,0,0,0,0,0,0,0,1,0,0,0,1,0,0,0,0,0,0,0,1,0,0,0,1,0,0,0,0,0
967,Meghalaya,2008,03. Dowry Deaths,0,2,1,0,0,0,3,0,4,5,5,4,2,1,0,0,0,5,0,0,2,3,0,4,1,12,2,0,9,12
968,Mizoram,2008,03. Dowry Deaths,0,0,0,0,0,0,0,0,0,0,0,0,0,0,0,0,0,0,0,0,0,0,0,0,0,0,0,0,0,0
969,Nagaland,2008,03. Dowry Deaths,0,0,0,0,0,0,0,0,0,0,0,0,0,0,0,0,0,0,0,0,0,0,0,0,0,0,0,0,0,0
970,Odisha,2008,03. Dowry Deaths,214,5,333,0,37,7,338,0,455,399,1354,1272,401,333,251,0,0,1605,566,0,733,693,93,185,225,2604,0,659,2570,3263
971,Puducherry,2008,03. Dowry Deaths,0,0,0,0,0,0,0,0,4,2,12,12,2,0,0,0,0,12,0,0,1,0,0,3,4,18,0,0,18,18
972,Punjab,2008,03. Dowry Deaths,46,7,88,0,39,15,95,0,93,75,355,352,128,88,85,0,0,440,137,0,286,224,108,325,367,931,20,245,952,1176
973,Rajasthan,2008,03. Dowry Deaths,138,3,348,10,121,90,351,0,50,52,1491,1412,439,348,259,0,0,1760,304,15,643,643,234,11,11,2689,0,538,2599,3242
974,Sikkim,2008,03. Dowry Deaths,0,0,0,0,0,0,0,0,0,0,0,0,0,0,0,0,0,0,0,0,0,0,0,0,0,0,0,0,0,0
975,Tamil Nadu,2008,03. Dowry Deaths,140,1,187,0,44,5,188,0,125,111,550,547,207,187,184,0,0,734,349,0,488,433,114,218,271,1101,2,463,1131,1564
976,Tripura,2008,03. Dowry Deaths,13,0,31,0,2,0,31,0,18,33,75,59,16,31,15,0,0,90,18,0,31,27,5,17,12,66,9,23,62,89
977,Uttar Pradesh,2008,03. Dowry Deaths,849,265,1777,68,870,159,2042,0,279,243,6937,6947,2237,1777,1719,0,0,8724,2907,200,8541,6439,3142,907,1177,22758,1832,6049,22568,29007
978,Uttarakhand,2008,03. Dowry Deaths,36,10,64,0,19,1,74,0,18,20,234,225,73,64,55,0,0,289,140,0,168,164,101,70,25,652,49,241,729,893
979,West Bengal,2008,03. Dowry Deaths,290,11,339,0,40,0,350,0,355,254,1703,1694,451,339,330,0,0,2033,876,0,1082,943,80,495,609,3056,25,956,3069,4012
980,Andaman & Nicobar Islands,2009,03. Dowry Deaths,0,0,1,0,0,0,1,0,1,1,4,3,1,1,0,0,0,4,0,0,0,1,0,2,1,4,0,0,3,4
981,Andhra Pradesh,2009,03. Dowry Deaths,378,4,500,0,62,26,504,0,309,293,1143,1083,546,500,440,0,0,1583,1200,11,1220,1270,284,661,592,3028,19,1484,3253,4523
982,Arunachal Pradesh,2009,03. Dowry Deaths,0,0,0,0,0,0,0,0,0,0,0,0,0,0,0,0,0,0,0,0,0,0,0,0,0,0,0,0,0,0
983,Assam,2009,03. Dowry Deaths,24,23,95,0,20,7,118,1,216,172,298,247,170,95,44,0,0,342,71,0,297,181,51,257,324,496,49,122,437,618
984,Bihar,2009,03. Dowry Deaths,453,201,705,0,140,136,906,0,1999,1746,3627,3515,1295,705,593,0,0,4220,1635,0,2908,2166,433,2245,2968,11054,19,2068,10956,13122
985,Chandigarh,2009,03. Dowry Deaths,1,1,2,0,2,0,3,0,0,1,7,8,2,2,3,0,0,10,2,0,3,6,6,3,0,20,0,8,22,28
986,Chhattisgarh,2009,03. Dowry Deaths,70,0,136,3,31,0,136,0,12,20,356,324,128,136,101,0,0,460,164,19,353,354,78,23,20,777,2,242,684,1038
987,Dadra & Nagar Haveli,2009,03. Dowry Deaths,0,0,0,0,0,0,0,0,1,1,1,1,0,0,0,0,0,1,0,0,0,0,0,1,1,3,0,0,3,3
988,Daman & Diu,2009,03. Dowry Deaths,0,0,0,0,0,0,0,0,0,0,1,1,0,0,0,0,0,1,0,0,0,0,0,0,0,0,0,0,0,0
989,Delhi,2009,03. Dowry Deaths,43,9,144,0,35,4,153,0,73,89,860,794,141,144,78,0,0,938,104,0,242,255,64,191,176,2167,2,168,2080,2335
990,Goa,2009,03. Dowry Deaths,2,0,2,0,0,0,2,0,3,2,8,8,3,2,2,0,0,10,2,0,3,2,0,0,1,23,0,2,23,25
991,Gujarat,2009,03. Dowry Deaths,19,0,20,1,0,0,20,0,6,2,503,503,24,20,19,0,0,523,55,1,53,55,0,8,6,1656,0,55,1657,1712
992,Haryana,2009,03. Dowry Deaths,174,0,253,4,63,26,253,0,35,33,515,503,281,253,237,0,0,756,407,18,633,635,142,48,46,1320,0,549,1252,1887
993,Himachal Pradesh,2009,03. Dowry Deaths,3,0,2,0,1,0,2,0,0,1,21,23,1,2,4,0,0,25,2,0,3,5,5,2,0,79,0,7,81,86
994,Jammu & Kashmir,2009,03. Dowry Deaths,7,0,18,0,1,0,18,0,2,8,55,45,12,18,8,0,0,63,10,0,46,45,1,2,3,136,0,11,102,147
995,Jharkhand,2009,03. Dowry Deaths,152,46,281,4,80,18,327,0,302,352,464,419,295,281,232,0,0,700,190,2,562,541,167,438,450,925,9,357,743,1284
996,Karnataka,2009,03. Dowry Deaths,143,22,205,5,13,6,227,16,106,91,602,558,264,205,156,0,0,763,376,6,666,537,33,133,254,1811,8,409,1689,2226
997,Kerala,2009,03. Dowry Deaths,19,0,21,0,2,0,21,0,27,28,151,151,20,21,21,0,0,172,33,0,32,33,3,29,28,289,0,36,292,325
998,Lakshadweep,2009,03. Dowry Deaths,0,0,0,0,0,0,0,0,0,0,0,0,0,0,0,0,0,0,0,0,0,0,0,0,0,0,0,0,0,0
999,Madhya Pradesh,2009,03. Dowry Deaths,409,2,938,7,257,2,940,0,66,150,2024,1759,858,938,666,0,0,2697,1148,27,2474,2473,621,67,63,6107,5,1769,5430,7903
1000,Maharashtra,2009,03. Dowry Deaths,193,1,334,7,30,2,335,0,132,128,3452,3348,341,334,223,0,0,3682,713,12,1233,1205,83,438,462,9912,4,796,9515,10720
1001,Manipur,2009,03. Dowry Deaths,0,0,0,0,0,0,0,0,1,1,0,0,0,0,0,0,0,0,0,0,0,0,0,1,1,0,0,0,0,0
1002,Meghalaya,2009,03. Dowry Deaths,0,0,0,0,0,0,0,0,4,4,5,5,0,0,0,0,0,5,0,0,0,0,0,1,1,12,0,0,12,12
1003,Mizoram,2009,03. Dowry Deaths,0,0,0,0,0,0,0,0,0,0,0,0,0,0,0,0,0,0,0,0,0,0,0,0,0,0,0,0,0,0
1004,Nagaland,2009,03. Dowry Deaths,0,0,0,0,0,0,0,0,0,0,0,0,0,0,0,0,0,0,0,0,0,0,0,0,0,0,0,0,0,0
1005,Odisha,2009,03. Dowry Deaths,211,1,346,0,47,5,347,1,486,455,1442,1354,384,346,258,0,0,1700,663,0,857,850,81,225,232,2710,0,744,2604,3454
1006,Puducherry,2009,03. Dowry Deaths,0,0,3,0,1,0,3,0,1,4,14,12,0,3,1,0,0,15,0,0,0,4,4,4,0,18,0,4,18,22
1007,Punjab,2009,03. Dowry Deaths,60,9,97,1,61,8,106,0,105,93,330,355,126,97,121,0,0,452,142,3,323,248,154,367,439,880,3,296,931,1179
1008,Rajasthan,2009,03. Dowry Deaths,135,5,331,31,93,104,336,0,46,50,1563,1491,436,331,228,0,0,1822,290,46,553,550,188,11,14,2715,0,478,2689,3239
1009,Sikkim,2009,03. Dowry Deaths,0,0,0,0,0,0,0,0,0,0,0,0,0,0,0,0,0,0,0,0,0,0,0,0,0,0,0,0,0,0
1010,Tamil Nadu,2009,03. Dowry Deaths,149,6,190,0,35,8,196,0,115,125,556,550,194,190,184,0,0,740,344,0,430,479,113,271,222,1123,0,457,1101,1580
1011,Tripura,2009,03. Dowry Deaths,14,4,27,0,7,0,31,0,16,18,81,75,29,27,21,0,0,102,37,0,60,57,14,12,15,72,0,51,66,123
1012,Uttar Pradesh,2009,03. Dowry Deaths,847,264,1786,57,823,158,2050,0,303,279,6996,6937,2232,1786,1670,0,0,8723,3086,120,9203,6518,3245,1177,1232,22825,2630,6331,22758,29276
1013,Uttarakhand,2009,03. Dowry Deaths,46,14,84,7,42,1,98,0,13,18,223,234,94,84,88,0,0,318,127,0,218,194,87,25,32,632,17,214,652,846
1014,West Bengal,2009,03. Dowry Deaths,193,8,372,0,36,0,380,1,480,355,1846,1703,506,372,229,0,0,2075,858,0,1002,825,92,609,738,2931,48,950,3056,3881
1015,Andaman & Nicobar Islands,2010,03. Dowry Deaths,0,0,0,0,0,0,0,0,1,1,4,4,0,0,0,0,0,4,0,0,0,0,0,1,1,4,0,0,4,4
1016,Andhra Pradesh,2010,03. Dowry Deaths,422,3,543,8,80,17,546,3,331,309,1175,1143,588,543,502,1,0,1685,1282,94,1322,1383,230,592,510,2805,21,1512,3028,4411
1017,Arunachal Pradesh,2010,03. Dowry Deaths,0,0,0,0,0,0,0,0,0,0,0,0,0,0,0,0,0,0,0,0,0,0,0,0,0,0,0,0,0,0
1018,Assam,2010,03. Dowry Deaths,45,36,132,0,13,6,168,1,216,216,372,298,175,132,58,0,0,430,97,0,263,192,24,324,360,567,35,121,496,688
1019,Bihar,2010,03. Dowry Deaths,436,80,831,7,146,82,911,0,2263,1999,3869,3627,1257,831,582,0,0,4458,1242,21,2508,2658,351,2968,2729,12098,89,1593,11054,13712
1020,Chandigarh,2010,03. Dowry Deaths,4,0,4,0,2,0,4,0,1,0,5,7,5,4,6,0,0,11,11,0,10,10,5,0,0,14,0,16,20,30
1021,Chhattisgarh,2010,03. Dowry Deaths,47,0,108,0,31,1,108,0,18,12,386,356,115,108,78,0,0,464,155,0,277,261,81,20,24,802,12,236,777,1038
1022,Dadra & Nagar Haveli,2010,03. Dowry Deaths,0,0,0,0,0,0,0,0,1,1,1,1,0,0,0,0,0,1,0,0,0,0,0,1,1,3,0,0,3,3
1023,Daman & Diu,2010,03. Dowry Deaths,1,0,0,0,0,0,0,0,0,0,0,1,0,0,1,0,0,1,1,0,0,0,0,0,0,0,0,1,1,1
1024,Delhi,2010,03. Dowry Deaths,104,3,136,0,27,0,139,0,77,73,865,860,143,136,131,0,0,996,151,0,209,199,68,176,181,2147,5,219,2167,2366
1025,Goa,2010,03. Dowry Deaths,1,0,0,0,1,0,0,0,4,3,6,8,1,0,2,0,0,8,2,0,5,0,1,1,6,20,0,3,23,23
1026,Gujarat,2010,03. Dowry Deaths,7,7,15,1,1,0,22,0,3,6,509,503,19,15,8,0,0,518,15,0,28,34,4,6,0,1671,0,19,1656,1690
1027,Haryana,2010,03. Dowry Deaths,134,5,253,5,89,31,258,0,30,35,540,515,284,253,223,0,0,768,365,11,589,590,223,46,45,1311,0,588,1320,1910
1028,Himachal Pradesh,2010,03. Dowry Deaths,1,0,2,0,0,0,2,0,0,0,22,21,2,2,1,0,0,23,3,0,4,4,0,0,0,80,0,3,79,83
1029,Jammu & Kashmir,2010,03. Dowry Deaths,8,0,9,0,0,0,9,0,2,2,56,55,9,9,8,0,0,64,17,0,26,24,0,3,5,143,0,17,136,160
1030,Jharkhand,2010,03. Dowry Deaths,176,38,235,6,74,11,273,0,294,302,443,464,276,235,250,0,0,699,344,19,567,585,186,450,432,961,0,530,925,1510
1031,Karnataka,2010,03. Dowry Deaths,149,2,246,4,32,9,248,1,96,106,661,602,248,246,181,2,0,846,566,25,621,717,62,254,152,1875,6,628,1811,2528
1032,Kerala,2010,03. Dowry Deaths,12,6,26,0,1,0,32,0,17,27,164,151,22,26,13,0,0,177,22,0,34,47,2,28,13,312,2,24,289,336
1033,Lakshadweep,2010,03. Dowry Deaths,0,0,0,0,0,0,0,0,0,0,0,0,0,0,0,0,0,0,0,0,0,0,0,0,0,0,0,0,0,0
1034,Madhya Pradesh,2010,03. Dowry Deaths,435,4,877,6,230,0,881,0,77,66,2230,2024,892,877,665,0,0,2901,1401,14,2564,2574,656,63,53,6610,0,2057,6107,8681
1035,Maharashtra,2010,03. Dowry Deaths,307,4,401,3,22,3,405,0,117,132,3521,3452,393,401,329,0,0,3853,971,3,1438,1377,63,462,520,10252,3,1034,9912,11289
1036,Manipur,2010,03. Dowry Deaths,0,0,0,0,0,0,0,0,1,1,0,0,0,0,0,0,0,0,0,0,0,0,0,1,1,0,0,0,0,0
1037,Meghalaya,2010,03. Dowry Deaths,0,0,0,0,0,0,0,0,4,4,5,5,0,0,0,0,0,5,0,0,0,0,0,1,1,12,0,0,12,12
1038,Mizoram,2010,03. Dowry Deaths,0,0,0,0,0,0,0,0,0,0,0,0,0,0,0,0,0,0,0,0,0,0,0,0,0,0,0,0,0,0
1039,Nagaland,2010,03. Dowry Deaths,0,0,0,0,0,0,0,0,0,0,0,0,0,0,0,0,0,0,0,0,0,0,0,0,0,0,0,0,0,0
1040,Odisha,2010,03. Dowry Deaths,365,4,485,0,50,4,489,1,380,486,1512,1442,388,485,415,0,0,1927,802,0,988,1048,131,232,172,2825,0,933,2710,3758
1041,Puducherry,2010,03. Dowry Deaths,1,0,1,0,0,0,1,0,1,1,14,14,1,1,1,0,0,15,2,0,4,1,0,0,3,17,0,2,18,19
1042,Punjab,2010,03. Dowry Deaths,52,19,104,0,56,19,123,0,81,102,281,285,121,104,108,0,0,389,155,0,288,292,138,384,359,762,21,293,763,1055
1043,Rajasthan,2010,03. Dowry Deaths,131,5,347,16,100,86,352,0,70,46,1663,1563,462,347,231,0,0,1910,271,32,616,610,183,14,20,2839,0,454,2715,3325
1044,Sikkim,2010,03. Dowry Deaths,0,0,0,0,0,0,0,0,1,0,0,0,1,0,0,0,0,0,0,0,2,0,0,0,2,0,0,0,0,0
1045,Tamil Nadu,2010,03. Dowry Deaths,118,7,151,0,46,5,158,0,117,115,543,556,165,151,164,0,0,707,348,0,313,300,102,222,235,973,0,450,1123,1423
1046,Tripura,2010,03. Dowry Deaths,15,0,23,0,3,0,23,0,18,16,86,81,25,23,18,0,0,104,43,0,62,56,6,15,19,79,2,49,72,128
1047,Uttar Pradesh,2010,03. Dowry Deaths,839,288,1757,31,992,165,2045,0,310,303,6891,6996,2217,1757,1831,0,0,8753,2897,127,9250,5958,3828,1232,1257,21931,3267,6725,22825,28783
1048,Uttarakhand,2010,03. Dowry Deaths,47,11,60,0,39,4,71,0,13,13,197,223,75,60,86,0,0,283,156,0,168,163,104,32,22,535,15,260,632,795
1049,West Bengal,2010,03. Dowry Deaths,205,7,486,3,24,0,493,0,494,480,2100,1846,507,486,229,0,0,2332,844,9,1124,1101,55,738,711,3124,50,899,2931,4032
1050,Andaman & Nicobar Islands,2001,04. Molestation,1,0,27,0,0,0,27,0,1,9,97,71,19,27,1,0,0,98,2,0,19,27,0,12,4,97,0,2,72,99
1051,Andhra Pradesh,2001,04. Molestation,1687,47,3158,835,581,403,3205,25,736,825,4708,4686,3544,3158,2268,33,0,7811,2029,934,3639,3273,544,933,1111,5177,188,2573,5411,8684
1052,Arunachal Pradesh,2001,04. Molestation,6,9,68,7,28,0,77,0,10,9,141,114,78,68,34,0,0,182,9,9,95,69,32,21,21,162,26,41,143,212
1053,Assam,2001,04. Molestation,365,198,493,43,75,42,691,2,575,460,1145,1135,850,493,440,0,0,1628,478,71,1161,735,87,439,564,1726,301,565,1627,2362
1054,Bihar,2001,04. Molestation,168,39,489,17,85,14,528,0,152,132,995,776,562,489,253,0,0,1265,373,27,982,802,152,264,364,1704,80,525,1454,2256
1055,Chandigarh,2001,04. Molestation,12,2,23,0,16,0,25,0,1,2,44,49,24,23,28,0,0,72,19,0,33,34,21,4,3,75,0,40,81,115
1056,Chhattisgarh,2001,04. Molestation,193,12,1767,398,231,13,1779,0,27,56,6531,5586,1763,1767,424,0,0,7353,387,473,2106,2127,432,29,8,7991,0,819,7156,9283
1057,Dadra & Nagar Haveli,2001,04. Molestation,4,0,8,0,0,0,8,0,1,2,14,10,7,8,4,0,0,18,6,0,7,9,0,3,1,14,0,6,11,20
1058,Daman & Diu,2001,04. Molestation,0,0,0,0,0,0,0,0,0,0,0,0,0,0,0,0,0,0,0,0,0,0,0,0,0,0,0,0,0,0
1059,Delhi,2001,04. Molestation,217,57,480,0,146,7,537,0,90,132,931,814,502,480,363,0,0,1294,206,0,650,547,178,182,237,1667,48,384,1504,2051
1060,Goa,2001,04. Molestation,28,2,19,6,7,0,21,0,5,9,43,65,17,19,35,0,0,84,40,6,15,22,9,12,5,61,0,49,94,116
1061,Gujarat,2001,04. Molestation,511,9,767,127,35,9,776,0,25,54,5208,5114,756,767,546,0,0,5881,745,146,1033,1055,41,53,31,6998,0,786,6875,7930
1062,Haryana,2001,04. Molestation,407,32,426,14,126,43,458,0,18,41,1897,2018,478,426,533,0,0,2444,581,2,567,580,170,22,9,2590,0,751,2763,3343
1063,Himachal Pradesh,2001,04. Molestation,160,1,297,108,24,24,298,0,26,38,1009,1006,310,297,184,2,0,1301,258,179,431,432,35,32,26,1419,5,293,1459,1891
1064,Jammu & Kashmir,2001,04. Molestation,224,10,564,65,26,48,574,0,104,104,1403,1154,622,564,250,0,0,1718,470,108,1034,1028,27,6,3,5236,9,497,4813,5841
1065,Jharkhand,2001,04. Molestation,148,25,268,26,29,5,293,0,46,47,1170,1105,297,268,177,0,0,1373,155,36,384,367,34,466,423,1448,60,189,1306,1673
1066,Karnataka,2001,04. Molestation,848,118,1576,425,50,68,1694,3,242,342,3067,2815,1665,1576,898,1,0,4390,1579,691,2401,2342,76,226,194,3782,91,1655,3786,6128
1067,Kerala,2001,04. Molestation,655,22,1707,375,97,138,1729,8,291,224,4936,4356,1942,1707,752,0,0,6063,894,510,2317,2278,80,229,241,6544,27,974,5750,8028
1068,Lakshadweep,2001,04. Molestation,0,0,0,0,0,0,0,0,0,0,0,0,0,0,0,0,0,0,0,0,0,0,0,0,0,0,0,0,0,0
1069,Madhya Pradesh,2001,04. Molestation,2483,16,7022,2444,1291,3,7038,1,97,137,21335,20533,7063,7022,3774,2,61,27553,2861,2904,8196,8102,1576,47,83,24188,58,4437,23427,31529
1070,Maharashtra,2001,04. Molestation,1274,57,2726,655,157,29,2783,0,372,361,18485,17845,2823,2726,1431,0,0,20571,1523,812,3385,3376,189,285,288,22508,6,1712,21656,25032
1071,Manipur,2001,04. Molestation,0,33,1,0,1,0,34,0,15,28,2,2,21,1,1,0,0,3,0,0,12,1,1,4,4,6,11,1,6,7
1072,Meghalaya,2001,04. Molestation,8,5,18,0,2,0,23,0,14,12,92,84,25,18,10,0,0,102,10,0,13,15,2,6,4,112,0,12,109,124
1073,Mizoram,2001,04. Molestation,9,1,52,0,50,0,53,0,3,4,53,60,52,52,59,0,0,112,17,4,58,62,45,16,11,61,1,62,65,127
1074,Nagaland,2001,04. Molestation,0,1,5,0,0,0,6,0,2,2,14,9,6,5,0,0,0,14,0,1,0,1,0,3,2,4,0,0,4,5
1075,Odisha,2001,04. Molestation,1121,46,1579,1,120,51,1625,0,260,281,6533,6196,1655,1579,1241,0,0,7775,1370,12,2278,2247,189,33,44,10567,20,1559,9891,12138
1076,Puducherry,2001,04. Molestation,7,0,29,13,6,0,29,1,5,0,39,36,35,29,13,0,0,65,22,22,66,58,11,0,8,69,0,33,66,124
1077,Punjab,2001,04. Molestation,74,99,182,12,25,56,281,0,198,163,396,325,372,182,99,0,0,507,61,7,462,251,46,293,471,620,33,107,483,734
1078,Rajasthan,2001,04. Molestation,765,7,2284,573,804,604,2291,0,26,43,7905,7763,2878,2284,1569,0,0,10047,1032,758,3282,3282,1124,0,0,11965,0,2156,11597,14879
1079,Sikkim,2001,04. Molestation,0,0,0,0,0,0,0,0,0,0,0,0,0,0,0,0,0,0,0,0,0,0,0,0,0,0,0,0,0,0
1080,Tamil Nadu,2001,04. Molestation,861,31,1683,134,677,128,1714,12,160,243,3209,3198,1773,1683,1538,0,2,4881,1319,9,2283,2262,1037,389,318,4798,92,2356,4901,7163
1081,Tripura,2001,04. Molestation,21,7,38,3,3,0,45,0,41,28,147,136,58,38,24,0,0,174,39,0,62,49,6,38,24,66,27,45,62,111
1082,Uttar Pradesh,2001,04. Molestation,781,154,2572,123,1201,128,2726,0,199,183,6658,6191,2870,2572,1982,0,0,8763,1172,175,3960,3834,1776,223,258,9900,91,2948,9189,13023
1083,Uttarakhand,2001,04. Molestation,33,15,81,10,57,4,96,0,9,6,221,240,103,81,90,0,0,321,37,24,150,140,71,7,8,322,9,108,314,454
1084,West Bengal,2001,04. Molestation,350,109,825,4,70,11,934,0,1211,1202,4949,4548,954,825,420,0,0,5373,456,0,1163,929,85,824,824,4877,234,541,4489,5418
1085,Andaman & Nicobar Islands,2002,04. Molestation,7,1,13,0,3,0,14,0,4,1,100,97,17,13,10,0,0,110,7,0,17,16,3,4,4,103,1,10,97,113
1086,Andhra Pradesh,2002,04. Molestation,1517,47,3016,1007,393,539,3063,20,913,736,4807,4708,3799,3016,1910,0,0,7724,1821,986,4055,3792,470,1111,1113,5692,261,2291,5177,8969
1087,Arunachal Pradesh,2002,04. Molestation,6,10,59,8,11,0,69,0,9,10,175,141,68,59,17,0,0,200,4,7,80,75,14,21,18,212,8,18,162,237
1088,Assam,2002,04. Molestation,300,196,666,52,86,71,862,3,623,575,1373,1145,984,666,386,0,0,1811,478,68,1372,981,122,564,717,2039,238,600,1726,2707
1089,Bihar,2002,04. Molestation,176,48,493,21,31,17,541,0,215,152,1260,995,621,493,207,0,0,1488,281,25,997,927,76,364,240,2249,194,357,1704,2631
1090,Chandigarh,2002,04. Molestation,15,1,33,0,8,0,34,0,3,1,54,44,36,33,23,0,0,77,27,0,39,36,12,3,2,72,4,39,75,111
1091,Chhattisgarh,2002,04. Molestation,582,14,1468,753,743,9,1482,0,19,27,5921,6531,1483,1468,1325,0,0,7999,1039,506,1728,1650,843,8,86,7253,0,1882,7991,9641
1092,Dadra & Nagar Haveli,2002,04. Molestation,3,0,3,0,0,0,3,0,1,1,14,14,3,3,3,0,0,17,4,0,2,3,0,1,0,13,0,4,14,17
1093,Daman & Diu,2002,04. Molestation,0,0,0,0,0,0,0,0,0,0,0,0,0,0,0,0,0,0,0,0,0,0,0,0,0,0,0,0,0,0
1094,Delhi,2002,04. Molestation,79,21,425,0,53,1,446,1,85,90,1224,931,446,425,132,0,3,1356,113,0,634,570,65,237,288,2059,13,178,1667,2237
1095,Goa,2002,04. Molestation,7,1,14,2,6,0,15,0,8,5,42,43,18,14,13,0,0,57,16,3,24,21,7,5,7,56,1,23,61,82
1096,Gujarat,2002,04. Molestation,419,15,725,86,32,14,740,1,20,25,5396,5208,750,725,451,0,0,5933,551,122,1015,1029,38,31,17,7316,0,589,6998,8027
1097,Haryana,2002,04. Molestation,463,20,379,14,100,54,399,0,19,18,1699,1897,454,379,563,0,0,2276,638,13,603,605,110,9,7,2434,0,748,2590,3195
1098,Himachal Pradesh,2002,04. Molestation,115,1,273,62,12,22,274,0,56,26,1093,1009,326,273,127,0,0,1282,167,93,419,415,20,26,29,1554,1,187,1419,1834
1099,Jammu & Kashmir,2002,04. Molestation,286,9,703,56,24,52,712,0,125,104,1740,1403,785,703,310,0,0,2106,991,142,1377,1368,43,3,11,5428,1,1034,5236,6604
1100,Jharkhand,2002,04. Molestation,426,11,364,16,63,9,375,0,65,38,1033,1174,411,364,489,0,0,1538,648,21,433,419,81,356,266,1133,104,729,1464,1883
1101,Karnataka,2002,04. Molestation,810,71,1543,394,60,93,1614,5,178,242,3346,3067,1648,1543,870,0,0,4610,1434,618,2366,2139,63,194,307,3806,114,1497,3782,5921
1102,Kerala,2002,04. Molestation,602,30,1861,326,82,160,1891,5,358,291,5787,4936,2123,1861,684,0,0,6797,897,497,2568,2552,124,241,248,7578,9,1021,6544,9096
1103,Lakshadweep,2002,04. Molestation,0,0,1,0,0,0,1,0,0,0,1,0,1,1,0,0,0,1,0,0,1,1,0,0,0,1,0,0,0,1
1104,Madhya Pradesh,2002,04. Molestation,1966,60,7063,2317,1165,34,7123,0,58,97,22950,21335,7118,7063,3131,0,0,28398,2530,2554,8760,8774,1479,83,69,26399,0,4009,24188,32962
1105,Maharashtra,2002,04. Molestation,1533,36,2609,537,153,31,2645,1,381,372,18871,18485,2686,2609,1686,0,0,21094,1792,672,3260,3243,179,288,293,23108,12,1971,22508,25751
1106,Manipur,2002,04. Molestation,0,57,4,0,0,0,61,0,12,15,6,2,58,4,0,0,0,6,0,0,41,2,0,4,10,8,33,0,6,8
1107,Meghalaya,2002,04. Molestation,4,6,14,0,5,0,20,0,17,14,97,92,23,14,9,0,0,106,6,0,14,10,4,4,5,112,3,10,112,122
1108,Mizoram,2002,04. Molestation,4,1,39,0,24,0,40,0,38,5,27,16,73,39,28,0,0,55,4,0,55,46,39,3,12,49,0,43,46,92
1109,Nagaland,2002,04. Molestation,0,0,1,0,1,0,1,0,2,2,14,14,1,1,1,0,0,15,0,0,1,1,1,2,2,4,0,1,4,5
1110,Odisha,2002,04. Molestation,761,63,1405,12,97,84,1468,1,312,260,7068,6533,1605,1405,858,0,0,7938,1514,15,2316,2211,158,44,149,11091,0,1672,10567,12778
1111,Puducherry,2002,04. Molestation,9,0,60,14,7,1,60,0,3,5,69,39,59,60,16,0,0,99,21,14,78,79,11,8,7,102,0,32,69,148
1112,Punjab,2002,04. Molestation,105,66,258,13,74,37,324,3,175,198,462,396,341,258,179,0,0,654,168,19,425,432,115,471,409,750,55,283,620,1052
1113,Rajasthan,2002,04. Molestation,655,12,2157,589,817,542,2169,0,45,26,8001,7905,2730,2157,1472,0,0,10062,1061,884,2967,2966,1153,0,1,11833,0,2214,11965,14931
1114,Sikkim,2002,04. Molestation,0,5,6,2,2,0,11,0,6,0,2,0,17,6,2,0,0,6,1,1,17,5,1,0,5,2,7,2,0,5
1115,Tamil Nadu,2002,04. Molestation,900,14,1752,41,868,150,1766,16,105,160,3152,3209,1877,1752,1768,0,0,4961,1532,37,2847,2919,1359,318,142,4789,104,2891,4798,7717
1116,Tripura,2002,04. Molestation,55,16,109,2,6,0,125,0,44,41,193,147,128,109,61,0,0,256,65,2,95,85,5,24,15,79,19,70,66,151
1117,Uttar Pradesh,2002,04. Molestation,731,84,2122,134,1196,102,2206,0,36,199,6719,6658,2145,2122,1927,0,0,8780,1093,178,2944,3059,1755,258,47,9933,96,2848,9900,12959
1118,Uttarakhand,2002,04. Molestation,21,16,126,23,37,2,142,0,10,9,266,221,145,126,58,0,0,347,38,45,234,195,74,8,31,360,16,112,322,517
1119,West Bengal,2002,04. Molestation,762,196,980,0,149,2,1176,0,997,1211,5018,4949,964,980,911,0,0,5929,869,0,1377,1088,181,824,1027,4915,86,1050,4877,5965
1120,Andaman & Nicobar Islands,2003,04. Molestation,6,0,12,0,0,0,12,0,1,4,106,100,9,12,6,0,0,112,7,0,12,15,0,4,1,111,0,7,103,118
1121,Andhra Pradesh,2003,04. Molestation,1527,43,3250,900,373,639,3293,30,1078,913,5257,4807,4128,3250,1900,0,1,8057,2216,1120,4577,4295,487,1113,1201,6164,194,2703,5692,9987
1122,Arunachal Pradesh,2003,04. Molestation,2,4,37,0,2,0,41,0,11,9,208,175,43,37,4,0,0,212,2,0,66,30,2,18,25,238,29,4,212,242
1123,Assam,2003,04. Molestation,380,249,602,92,62,151,851,3,496,623,1441,1373,878,602,442,0,0,1975,649,186,1660,1136,108,717,808,2232,433,757,2039,3175
1124,Bihar,2003,04. Molestation,245,85,524,57,54,25,609,0,269,215,1428,1260,688,524,299,0,0,1784,374,75,965,832,91,240,243,2541,130,465,2249,3081
1125,Chandigarh,2003,04. Molestation,2,1,12,0,10,1,13,0,0,3,54,54,11,12,12,0,0,66,18,0,19,19,2,2,0,71,2,20,72,91
1126,Chhattisgarh,2003,04. Molestation,205,15,1385,853,272,5,1400,1,94,19,5976,5921,1481,1385,477,0,0,7306,424,846,1755,1753,401,87,89,7555,0,825,7473,9226
1127,Dadra & Nagar Haveli,2003,04. Molestation,1,0,3,0,0,0,3,0,2,1,16,14,4,3,1,0,0,17,2,0,7,2,0,0,5,14,0,2,14,16
1128,Daman & Diu,2003,04. Molestation,0,0,2,0,0,0,2,0,1,0,2,0,3,2,0,0,0,2,0,0,3,2,0,0,1,2,0,0,0,2
1129,Delhi,2003,04. Molestation,222,22,446,0,81,2,468,0,104,85,1367,1224,489,446,303,0,0,1670,438,0,647,573,168,288,353,2026,9,606,2059,2632
1130,Goa,2003,04. Molestation,10,3,11,3,2,0,14,0,13,8,38,42,19,11,12,0,0,53,13,3,15,13,3,7,7,50,2,16,56,69
1131,Gujarat,2003,04. Molestation,384,12,681,108,32,17,693,0,32,20,5553,5396,722,681,416,0,0,6077,530,149,970,954,30,17,33,7561,0,560,7316,8270
1132,Haryana,2003,04. Molestation,350,3,304,5,106,43,307,0,13,19,1542,1699,344,304,456,0,0,2003,461,2,475,477,133,7,5,2315,0,594,2434,2911
1133,Himachal Pradesh,2003,04. Molestation,131,4,254,72,31,17,258,0,31,56,1113,1093,250,254,162,0,0,1347,202,129,335,345,37,29,18,1531,1,239,1554,1899
1134,Jammu & Kashmir,2003,04. Molestation,329,5,864,48,38,34,869,0,97,125,2189,1740,875,864,367,0,0,2604,751,85,1966,1975,63,11,2,6504,0,814,5428,7403
1135,Jharkhand,2003,04. Molestation,395,15,368,17,53,5,383,0,101,65,936,1033,424,368,448,0,0,1401,180,5,425,277,57,266,331,1168,83,237,1133,1410
1136,Karnataka,2003,04. Molestation,766,66,1425,331,74,100,1491,13,159,178,3600,3346,1585,1425,840,0,0,4771,1249,388,2266,2257,82,307,214,4344,102,1331,3806,6063
1137,Kerala,2003,04. Molestation,682,26,1708,458,111,172,1734,2,397,358,6244,5787,1947,1708,793,0,0,7495,940,642,2328,2176,153,248,305,8019,95,1093,7578,9754
1138,Lakshadweep,2003,04. Molestation,0,0,0,0,1,0,0,0,1,0,0,1,1,0,1,0,0,1,0,0,1,0,1,0,1,0,0,1,1,1
1139,Madhya Pradesh,2003,04. Molestation,2331,44,6636,2284,1609,19,6680,0,200,51,23008,22596,6848,6636,3940,0,0,29232,2625,2750,8326,8317,1683,11,20,28556,0,4308,27297,35614
1140,Maharashtra,2003,04. Molestation,1284,75,2461,538,164,35,2536,0,471,381,19345,18871,2661,2461,1448,1,0,21331,1590,665,3147,3034,192,293,399,23695,7,1782,23108,26142
1141,Manipur,2003,04. Molestation,0,27,1,0,0,0,28,0,28,12,7,6,44,1,0,0,0,7,0,0,54,1,0,10,27,9,36,0,8,9
1142,Meghalaya,2003,04. Molestation,6,4,16,0,3,0,20,0,10,17,104,97,13,16,9,0,0,113,4,0,25,4,1,5,25,111,1,5,112,116
1143,Mizoram,2003,04. Molestation,7,2,86,1,46,0,88,0,11,11,110,78,88,86,53,0,0,164,9,0,96,83,82,12,25,41,0,91,49,132
1144,Nagaland,2003,04. Molestation,0,1,2,0,0,0,3,0,3,2,16,14,4,2,0,0,0,16,0,0,3,3,0,2,2,7,0,0,4,7
1145,Odisha,2003,04. Molestation,889,37,1673,0,125,106,1710,0,165,312,7727,7068,1669,1673,1014,0,0,8741,1364,19,2440,2517,223,149,72,12002,0,1587,11091,13608
1146,Puducherry,2003,04. Molestation,8,0,55,20,11,2,55,0,2,3,85,69,56,55,19,0,0,124,13,34,78,84,12,7,1,127,0,25,102,186
1147,Punjab,2003,04. Molestation,131,72,281,4,79,54,353,1,113,175,529,462,346,281,210,0,0,743,175,5,439,382,135,409,385,817,81,310,750,1132
1148,Rajasthan,2003,04. Molestation,662,6,2129,406,648,584,2135,0,41,45,8414,8001,2715,2129,1310,0,0,10130,1012,641,2816,2817,876,1,0,12121,0,1888,11833,14650
1149,Sikkim,2003,04. Molestation,0,4,15,11,6,1,19,0,11,6,0,2,25,15,6,0,0,17,0,2,21,15,2,5,11,13,0,2,2,17
1150,Tamil Nadu,2003,04. Molestation,968,16,1743,14,717,156,1759,8,204,105,3326,3283,2022,1743,1685,1,0,5025,1554,11,2615,2485,985,194,303,4765,21,2539,4830,7315
1151,Tripura,2003,04. Molestation,52,26,99,0,5,0,125,0,46,44,235,193,127,99,57,0,0,292,23,0,157,77,5,15,56,128,39,28,79,156
1152,Uttar Pradesh,2003,04. Molestation,533,28,1014,101,842,45,1042,1,46,36,6257,6719,1098,1014,1375,0,0,7733,851,163,1518,1493,1276,47,59,9136,13,2127,9933,11426
1153,Uttarakhand,2003,04. Molestation,20,12,110,16,71,6,122,0,18,10,269,266,136,110,91,0,0,376,29,41,196,200,107,31,21,383,6,136,360,560
1154,West Bengal,2003,04. Molestation,559,151,1013,4,40,19,1164,0,1000,997,5428,5018,1186,1013,599,0,0,6031,655,6,2021,1533,48,1027,1119,5739,396,703,4915,6448
1155,Andaman & Nicobar Islands,2004,04. Molestation,1,1,5,0,6,0,6,0,1,1,104,106,6,5,7,0,0,111,1,0,13,12,6,1,2,116,0,7,111,123
1156,Andhra Pradesh,2004,04. Molestation,1987,47,3060,937,486,500,3107,10,1278,1078,4905,5257,3817,3060,2473,2,0,8315,2123,960,4259,4039,757,1201,1228,6363,193,2880,6164,10203
1157,Arunachal Pradesh,2004,04. Molestation,3,6,44,3,5,0,50,0,22,11,241,208,61,44,8,0,0,252,4,4,68,44,6,25,33,268,16,10,238,282
1158,Assam,2004,04. Molestation,484,210,568,50,68,105,778,0,496,496,1407,1441,883,568,552,0,0,2009,799,137,1322,960,122,808,748,2134,422,921,2232,3192
1159,Bihar,2004,04. Molestation,262,67,606,19,55,23,673,0,277,269,1698,1428,704,606,317,0,0,2034,525,21,1058,959,75,243,266,2879,76,600,2541,3500
1160,Chandigarh,2004,04. Molestation,9,0,16,0,6,1,16,0,3,0,55,54,20,16,15,0,0,70,10,0,24,19,6,0,5,74,0,16,71,90
1161,Chhattisgarh,2004,04. Molestation,502,13,1713,731,364,7,1726,1,21,94,6092,5976,1661,1713,866,0,0,7689,1050,1541,1972,2036,483,89,3,6517,22,1533,7555,9591
1162,Dadra & Nagar Haveli,2004,04. Molestation,5,0,6,0,0,0,6,0,1,2,17,16,5,6,5,0,0,22,5,0,8,11,0,5,2,20,0,5,14,25
1163,Daman & Diu,2004,04. Molestation,0,0,1,0,0,0,1,0,1,1,3,2,1,1,0,0,0,3,0,0,0,1,0,1,0,3,0,0,2,3
1164,Delhi,2004,04. Molestation,138,39,502,0,112,5,541,0,159,104,1619,1367,601,502,250,0,0,1869,147,0,756,688,112,353,410,2455,11,259,2026,2714
1165,Goa,2004,04. Molestation,7,8,18,5,1,0,26,0,10,13,43,38,23,18,8,0,0,56,12,6,24,20,1,7,9,51,2,13,50,70
1166,Gujarat,2004,04. Molestation,378,13,728,69,25,14,741,1,33,32,5809,5553,757,728,403,0,0,6281,510,100,1132,1128,26,33,37,8053,0,536,7561,8689
1167,Haryana,2004,04. Molestation,389,6,361,0,123,34,367,0,15,13,1391,1542,403,361,512,0,0,1903,588,0,491,486,201,5,10,2012,0,789,2315,2801
1168,Himachal Pradesh,2004,04. Molestation,170,4,269,139,20,22,273,0,20,31,1053,1113,284,269,190,0,0,1382,224,171,347,334,27,18,29,1443,2,251,1531,1865
1169,Jammu & Kashmir,2004,04. Molestation,476,11,928,39,57,40,939,0,108,97,2545,2189,990,928,533,0,0,3117,1316,81,1857,1852,60,2,7,6899,0,1376,6504,8356
1170,Jharkhand,2004,04. Molestation,395,15,368,17,53,5,383,0,124,101,839,936,411,368,448,0,0,1304,180,5,425,277,57,331,396,1203,83,237,1168,1445
1171,Karnataka,2004,04. Molestation,955,30,1289,293,50,83,1319,3,189,159,3591,3600,1435,1289,1005,0,0,4889,1186,409,1925,1916,49,214,160,4616,63,1235,4344,6260
1172,Kerala,2004,04. Molestation,866,36,2087,706,129,197,2123,7,330,397,6630,6244,2260,2087,995,0,0,8331,1223,889,2825,2736,231,305,344,8412,50,1454,8019,10755
1173,Lakshadweep,2004,04. Molestation,0,0,1,0,0,0,1,0,0,1,1,0,0,1,0,0,0,1,0,0,0,0,0,1,1,0,0,0,0,0
1174,Madhya Pradesh,2004,04. Molestation,2212,44,6741,2236,1503,18,6785,0,87,200,23798,23008,6690,6741,3715,0,0,29749,2660,2806,8022,8033,1601,20,9,29522,0,4261,28556,36589
1175,Maharashtra,2004,04. Molestation,1082,45,2698,573,153,29,2743,2,528,471,20235,19345,2831,2698,1235,0,0,22043,1416,714,3355,3289,179,399,461,24675,4,1595,23695,26984
1176,Manipur,2004,04. Molestation,0,9,1,0,0,0,10,0,48,28,8,7,30,1,0,0,0,8,0,0,26,1,0,27,21,10,31,0,9,10
1177,Meghalaya,2004,04. Molestation,6,1,9,1,2,0,10,0,34,10,104,104,34,9,8,0,0,113,7,1,17,10,1,25,28,112,4,8,111,121
1178,Mizoram,2004,04. Molestation,20,6,60,0,80,0,66,0,11,11,70,110,66,60,100,0,0,170,1,0,60,45,4,25,35,81,5,5,41,86
1179,Nagaland,2004,04. Molestation,0,2,4,0,19,0,6,0,0,3,1,16,3,4,19,0,0,20,2,0,2,4,4,2,0,5,0,6,7,11
1180,Odisha,2004,04. Molestation,956,26,1615,19,105,79,1641,0,256,165,8262,7727,1811,1615,1061,0,0,9342,1588,34,2468,2439,157,72,101,12662,0,1745,12002,14441
1181,Puducherry,2004,04. Molestation,17,0,50,16,8,1,50,1,0,2,94,85,50,50,25,0,0,135,41,35,94,95,12,1,0,134,0,53,127,222
1182,Punjab,2004,04. Molestation,114,51,186,18,83,24,237,5,108,113,500,529,261,186,197,0,0,715,88,14,337,494,79,385,187,1130,41,167,817,1311
1183,Rajasthan,2004,04. Molestation,840,3,2241,480,852,587,2244,0,35,41,8483,8414,2825,2241,1692,0,0,10655,1049,706,3150,3149,1134,0,1,12381,0,2183,12121,15270
1184,Sikkim,2004,04. Molestation,2,6,19,4,2,0,25,0,26,11,11,0,40,19,4,0,0,19,4,4,58,34,0,11,28,39,7,4,13,47
1185,Tamil Nadu,2004,04. Molestation,852,31,1776,1,878,93,1807,5,160,204,3371,3326,1861,1776,1730,0,0,5102,1375,65,2767,2731,1255,303,324,4801,15,2630,4765,7496
1186,Tripura,2004,04. Molestation,63,17,120,0,12,4,137,0,39,46,280,235,134,120,75,0,0,355,51,14,189,169,13,56,44,219,32,64,128,297
1187,Uttar Pradesh,2004,04. Molestation,627,68,1721,107,990,89,1789,0,68,46,6254,6257,1900,1721,1617,0,0,7978,936,136,2592,2520,1413,59,96,9171,35,2349,9136,11656
1188,Uttarakhand,2004,04. Molestation,23,16,132,15,64,2,148,0,11,18,299,269,143,132,87,0,0,401,28,22,222,207,116,21,20,424,16,144,383,590
1189,West Bengal,2004,04. Molestation,359,235,1366,0,45,3,1601,0,962,1000,6390,5428,1566,1366,404,0,0,6794,527,0,1714,1485,64,1119,1162,6633,186,591,5739,7224
1190,Andaman & Nicobar Islands,2005,04. Molestation,2,2,4,0,0,0,6,0,6,1,106,104,11,4,2,0,0,108,2,0,14,8,0,2,8,122,0,2,116,124
1191,Andhra Pradesh,2005,04. Molestation,1722,39,3203,1091,451,521,3242,0,1108,1278,4844,4905,3595,3203,2173,0,2,8108,2817,1167,4003,3703,575,1228,1409,5507,119,3392,6363,10066
1192,Arunachal Pradesh,2005,04. Molestation,17,20,54,7,16,0,74,0,15,22,255,241,67,54,33,0,0,295,18,7,51,44,19,33,17,268,23,37,268,312
1193,Assam,2005,04. Molestation,439,260,663,67,68,66,923,0,406,496,1496,1407,899,663,507,0,0,2070,687,90,1288,1012,162,748,674,2207,350,849,2134,3146
1194,Bihar,2005,04. Molestation,357,29,363,8,51,11,392,0,325,277,1645,1698,451,363,408,0,0,2061,600,16,715,598,66,266,335,2795,48,666,2879,3477
1195,Chandigarh,2005,04. Molestation,5,0,24,0,7,2,24,0,8,3,67,55,31,24,12,0,0,79,9,0,36,30,8,5,8,87,3,17,74,104
1196,Chhattisgarh,2005,04. Molestation,820,19,1418,331,454,4,1437,0,30,21,5905,6092,1450,1418,1274,0,0,7510,1045,617,1734,1730,500,3,7,6085,0,1545,6517,8247
1197,Dadra & Nagar Haveli,2005,04. Molestation,6,0,5,0,0,0,5,0,1,1,16,17,5,5,6,0,0,22,10,0,10,8,0,2,4,18,0,10,20,28
1198,Daman & Diu,2005,04. Molestation,0,1,1,0,0,0,2,0,0,1,4,3,1,1,0,0,0,4,0,0,1,1,0,0,0,4,0,0,3,4
1199,Delhi,2005,04. Molestation,76,26,562,0,74,2,588,1,329,159,2031,1619,762,562,150,0,1,2181,103,0,968,777,99,410,551,3030,50,202,2455,3232
1200,Goa,2005,04. Molestation,2,5,15,1,4,0,20,0,20,10,51,43,30,15,6,0,0,58,3,1,42,18,4,9,30,61,3,7,51,69
1201,Gujarat,2005,04. Molestation,498,17,762,41,100,5,779,0,51,33,5932,5809,802,762,598,0,0,6571,650,48,1064,1052,106,37,49,8301,0,756,8053,9105
1202,Haryana,2005,04. Molestation,227,5,333,4,104,34,338,0,23,15,1389,1391,380,333,331,0,0,1724,348,8,506,496,118,10,20,2034,0,466,2012,2508
1203,Himachal Pradesh,2005,04. Molestation,240,4,250,77,31,13,254,0,39,20,955,1053,286,250,271,0,0,1303,287,109,357,349,37,29,35,1359,2,324,1443,1792
1204,Jammu & Kashmir,2005,04. Molestation,474,6,736,65,17,42,742,0,154,108,2725,2545,830,736,491,0,0,3281,1116,160,1563,1531,31,7,1,7123,38,1147,6899,8430
1205,Jharkhand,2005,04. Molestation,27,39,245,12,123,6,284,0,127,124,917,839,293,245,150,5,0,1079,655,25,299,310,55,396,333,778,52,710,1203,1513
1206,Karnataka,2005,04. Molestation,1085,38,1358,320,52,107,1396,1,270,189,3492,3591,1585,1358,1137,0,0,4949,1644,403,2066,2034,119,160,127,4484,65,1763,4616,6650
1207,Kerala,2005,04. Molestation,799,20,2083,273,168,138,2103,0,428,330,7473,6630,2339,2083,967,0,0,8713,1134,437,2842,2660,369,344,504,9132,22,1503,8412,11072
1208,Lakshadweep,2005,04. Molestation,0,0,0,0,0,0,0,0,0,0,1,1,0,0,0,0,0,1,0,0,0,0,0,0,0,0,0,0,0,0
1209,Madhya Pradesh,2005,04. Molestation,2174,35,6317,2503,1282,30,6352,0,131,87,24156,23798,6426,6317,3456,0,0,30115,2931,2601,7762,7757,1677,9,14,30070,0,4608,29522,37279
1210,Maharashtra,2005,04. Molestation,1387,59,3021,479,158,29,3080,4,643,528,21228,20235,3228,3021,1545,4,0,23252,1664,604,3865,3816,181,461,507,26042,3,1845,24675,28491
1211,Manipur,2005,04. Molestation,0,22,1,0,0,0,23,0,50,48,9,8,25,1,0,0,0,9,0,0,27,1,0,21,16,11,31,0,10,11
1212,Meghalaya,2005,04. Molestation,4,5,20,1,2,0,25,0,53,34,117,104,44,20,6,0,0,124,5,0,21,16,2,28,31,121,2,7,112,128
1213,Mizoram,2005,04. Molestation,6,0,49,4,10,0,49,0,11,11,99,70,49,49,16,0,0,119,2,0,43,38,90,35,40,27,0,92,81,119
1214,Nagaland,2005,04. Molestation,1,0,6,0,1,0,6,0,1,0,5,1,7,6,2,0,0,7,0,0,7,7,2,0,0,10,0,2,5,12
1215,Odisha,2005,04. Molestation,830,23,1838,14,72,112,1861,0,521,256,9184,8262,2238,1838,902,0,0,10100,1416,1,3318,3273,143,101,138,14375,8,1559,12662,15935
1216,Puducherry,2005,04. Molestation,8,0,53,21,10,1,53,0,6,0,108,94,60,53,18,0,0,147,14,34,101,85,15,0,16,156,0,29,134,219
1217,Punjab,2005,04. Molestation,109,26,224,3,41,26,250,1,139,108,571,500,308,224,150,0,0,724,161,15,361,321,54,187,205,1221,22,215,1130,1451
1218,Rajasthan,2005,04. Molestation,645,9,1986,559,981,522,1995,0,21,35,8284,8483,2503,1986,1626,0,0,10469,1065,783,2885,2885,1351,1,1,12067,0,2416,12381,15266
1219,Sikkim,2005,04. Molestation,10,6,11,10,2,0,17,0,47,26,0,11,38,11,12,0,0,22,10,10,28,11,2,28,17,28,28,12,39,50
1220,Tamil Nadu,2005,04. Molestation,862,24,1581,12,799,147,1605,1,171,160,3279,3371,1764,1581,1661,0,0,4952,1584,3,2515,2609,1112,324,218,4711,12,2696,4801,7410
1221,Tripura,2005,04. Molestation,87,32,130,0,18,2,162,0,36,39,305,280,161,130,105,0,0,410,121,2,156,135,28,44,60,203,5,149,219,354
1222,Uttar Pradesh,2005,04. Molestation,605,47,1708,134,937,55,1755,0,93,68,6286,6254,1835,1708,1542,0,0,7962,877,208,2600,2543,1342,96,115,9287,38,2219,9171,11714
1223,Uttarakhand,2005,04. Molestation,25,4,95,2,27,2,99,0,10,11,340,299,100,95,52,0,0,394,35,3,149,143,54,20,21,475,5,89,424,567
1224,West Bengal,2005,04. Molestation,715,115,1453,0,55,6,1568,0,960,962,7073,6390,1572,1453,770,0,0,7843,826,0,2027,1781,69,1162,1213,7519,195,895,6633,8414
1225,Andaman & Nicobar Islands,2006,04. Molestation,4,2,13,0,0,0,15,0,5,6,115,106,14,13,4,0,0,119,4,0,19,19,0,8,8,137,0,4,122,141
1226,Andhra Pradesh,2006,04. Molestation,1408,67,3528,988,398,677,3595,0,1370,1108,5578,4844,4534,3528,1806,0,0,8372,2038,1188,4431,3917,895,1409,1814,5303,109,2933,5507,9424
1227,Arunachal Pradesh,2006,04. Molestation,13,9,33,4,9,0,42,0,36,15,262,255,63,33,22,0,0,288,13,5,40,38,11,17,14,277,5,24,268,306
1228,Assam,2006,04. Molestation,432,217,749,64,121,92,966,1,637,406,1628,1496,1290,749,553,0,0,2245,780,80,1716,1097,260,674,851,2184,442,1040,2207,3304
1229,Bihar,2006,04. Molestation,338,37,449,64,80,20,486,0,349,325,1612,1645,530,449,418,0,0,2094,564,94,720,743,117,335,287,2763,25,681,2795,3538
1230,Chandigarh,2006,04. Molestation,11,0,19,0,6,2,19,0,7,8,69,67,20,19,17,0,0,86,15,0,28,25,6,8,11,91,0,21,87,112
1231,Chhattisgarh,2006,04. Molestation,281,17,1554,235,362,5,1571,0,52,30,6581,5905,1598,1554,643,0,0,7459,585,376,1880,1850,495,7,37,6479,0,1080,6085,7935
1232,Dadra & Nagar Haveli,2006,04. Molestation,1,0,4,0,1,0,4,0,2,1,18,16,5,4,2,0,0,20,4,0,5,9,1,4,0,22,0,5,18,27
1233,Daman & Diu,2006,04. Molestation,1,0,1,0,0,0,1,0,1,0,4,4,2,1,1,0,0,5,1,0,5,2,0,0,3,5,0,1,4,6
1234,Delhi,2006,04. Molestation,70,29,670,0,98,2,699,1,342,329,2533,2031,718,670,168,0,3,2701,95,0,887,679,131,551,701,3483,58,226,3030,3709
1235,Goa,2006,04. Molestation,6,5,20,4,4,0,25,0,13,20,57,51,18,20,10,0,0,71,7,4,25,30,4,30,17,76,8,11,61,91
1236,Gujarat,2006,04. Molestation,350,14,700,54,26,6,714,1,66,51,6202,5932,736,700,376,0,0,6632,486,97,957,950,38,49,56,8630,0,524,8301,9251
1237,Haryana,2006,04. Molestation,184,1,393,2,115,55,394,0,60,23,1481,1389,486,393,299,0,0,1782,235,2,653,618,133,20,55,2282,0,368,2034,2652
1238,Himachal Pradesh,2006,04. Molestation,116,2,266,49,19,14,268,0,32,39,1037,955,275,266,135,0,0,1221,174,66,391,404,23,35,22,1500,0,197,1359,1763
1239,Jammu & Kashmir,2006,04. Molestation,514,5,897,87,65,40,902,0,172,154,2956,2725,960,897,579,0,0,3622,1090,192,2015,2015,113,1,1,7743,0,1203,7123,9138
1240,Jharkhand,2006,04. Molestation,200,26,344,17,62,8,370,0,163,127,982,917,414,344,262,0,0,1261,365,158,445,625,69,333,137,811,16,434,778,1403
1241,Karnataka,2006,04. Molestation,1113,44,1535,264,73,87,1579,1,284,270,3577,3492,1683,1535,1186,0,2,5027,1679,336,2445,2294,101,127,217,4662,61,1780,4484,6778
1242,Kerala,2006,04. Molestation,1324,42,2273,305,231,203,2315,0,453,428,7886,7473,2543,2273,1555,0,0,9746,1974,331,2951,2893,322,504,558,9398,4,2296,9132,12025
1243,Lakshadweep,2006,04. Molestation,0,0,0,0,0,0,0,0,0,0,1,1,0,0,0,0,0,1,0,0,0,0,0,0,0,0,0,0,0,0
1244,Madhya Pradesh,2006,04. Molestation,1795,28,6172,2420,1184,23,6200,0,151,131,24929,24156,6243,6172,2979,0,0,30328,2039,2597,7235,7229,1465,14,20,31198,0,3504,30070,37299
1245,Maharashtra,2006,04. Molestation,1290,48,3240,410,168,43,3288,0,791,643,22600,21228,3479,3240,1458,0,0,24468,1646,520,4246,4074,197,507,669,27753,10,1843,26042,30116
1246,Manipur,2006,04. Molestation,0,24,1,0,2,0,25,0,67,50,8,9,42,1,2,0,0,10,0,0,29,1,2,16,26,10,18,2,11,12
1247,Meghalaya,2006,04. Molestation,11,21,34,0,5,0,55,0,55,53,135,117,57,34,16,0,0,151,9,0,50,38,8,31,37,142,6,17,121,159
1248,Mizoram,2006,04. Molestation,6,0,56,0,134,0,56,0,6,11,15,99,51,56,140,0,0,155,9,0,60,62,49,40,38,31,0,58,27,89
1249,Nagaland,2006,04. Molestation,0,0,3,0,4,0,3,0,1,1,4,5,3,3,4,0,0,8,0,0,4,2,6,0,2,6,0,6,10,12
1250,Odisha,2006,04. Molestation,877,47,2097,0,144,115,2144,0,677,521,10260,9184,2415,2097,1021,0,0,11281,1518,0,3565,3435,244,138,263,16048,5,1762,14375,17810
1251,Puducherry,2006,04. Molestation,11,0,48,5,14,0,48,1,13,6,126,108,56,48,25,0,0,156,15,7,79,67,23,16,28,178,0,38,156,223
1252,Punjab,2006,04. Molestation,118,37,262,1,44,19,299,0,135,139,670,571,314,262,162,0,0,833,183,5,422,361,69,205,248,1325,18,252,1221,1582
1253,Rajasthan,2006,04. Molestation,671,40,2048,579,958,498,2088,0,17,21,8004,8284,2582,2048,1629,120,0,10212,965,1065,2975,2976,1243,1,0,11770,0,2208,12067,15043
1254,Sikkim,2006,04. Molestation,2,0,10,7,1,0,10,0,51,47,0,0,14,10,3,0,0,10,2,7,16,14,1,17,5,32,14,3,28,42
1255,Tamil Nadu,2006,04. Molestation,884,54,1072,4,588,70,1126,2,152,171,2875,3279,1179,1072,1472,0,0,4351,1354,1,1667,1655,730,218,219,4281,11,2084,4711,6366
1256,Tripura,2006,04. Molestation,84,54,153,0,13,2,207,0,34,36,361,305,207,153,97,0,0,458,103,7,162,130,16,60,14,207,78,119,203,333
1257,Uttar Pradesh,2006,04. Molestation,618,85,1914,146,998,89,1999,0,101,93,6438,6286,2096,1914,1616,0,0,8200,916,201,2785,2763,1575,115,98,9358,39,2491,9287,12050
1258,Uttarakhand,2006,04. Molestation,36,5,140,0,51,11,145,0,7,10,393,340,153,140,87,0,0,480,44,0,204,202,82,21,10,551,13,126,475,677
1259,West Bengal,2006,04. Molestation,966,341,1529,4,119,27,1870,0,900,960,7513,7073,1837,1529,1085,0,0,8602,1054,4,2004,1704,142,1213,1161,8023,352,1196,7519,9223
1260,Andaman & Nicobar Islands,2007,04. Molestation,2,1,20,0,1,0,21,0,5,5,132,115,21,20,3,0,0,135,5,0,32,30,1,8,10,161,0,6,137,167
1261,Andhra Pradesh,2007,04. Molestation,2401,217,3599,1375,654,698,3816,0,1262,1370,4745,5578,4406,3599,3055,2,0,9175,3022,1342,4893,4967,773,1814,1639,5133,101,3795,5303,10270
1262,Arunachal Pradesh,2007,04. Molestation,12,26,48,2,7,0,74,0,34,36,289,262,72,48,19,0,0,310,13,2,72,59,8,14,12,313,15,21,277,336
1263,Assam,2007,04. Molestation,633,171,586,54,94,116,757,0,553,637,1433,1628,789,586,727,0,0,2214,1030,89,1466,1045,114,851,848,1996,424,1144,2184,3229
1264,Bihar,2007,04. Molestation,290,81,724,51,82,40,805,0,357,349,1913,1612,853,724,372,0,0,2336,529,69,1360,1118,123,287,504,3160,25,652,2763,3881
1265,Chandigarh,2007,04. Molestation,17,0,18,0,2,5,18,0,16,7,68,69,32,18,19,0,0,87,26,0,39,24,2,11,22,87,4,28,91,115
1266,Chhattisgarh,2007,04. Molestation,466,17,1507,301,228,3,1524,0,74,52,7093,6581,1549,1507,694,0,0,8088,488,521,1831,1809,261,37,59,7018,0,749,6479,8288
1267,Dadra & Nagar Haveli,2007,04. Molestation,5,2,0,0,1,0,2,0,0,2,12,18,0,0,6,0,0,18,6,0,0,0,1,0,0,15,0,7,22,22
1268,Daman & Diu,2007,04. Molestation,0,0,1,0,1,0,1,0,0,1,4,4,0,1,1,0,0,5,0,0,0,3,1,3,0,7,0,1,5,8
1269,Delhi,2007,04. Molestation,119,18,716,0,138,1,734,0,475,342,2992,2533,868,716,257,0,0,3249,108,0,1143,1027,144,701,790,4258,27,252,3483,4510
1270,Goa,2007,04. Molestation,3,2,9,5,2,1,11,0,21,13,56,57,20,9,5,0,0,66,3,9,24,13,2,17,26,75,2,5,76,89
1271,Gujarat,2007,04. Molestation,369,14,804,57,27,10,818,2,58,66,6553,6202,822,804,396,0,0,7006,585,81,1227,1220,30,56,62,9154,1,615,8630,9850
1272,Haryana,2007,04. Molestation,223,7,403,8,87,42,410,0,25,60,1566,1481,417,403,310,0,0,1884,352,8,572,584,125,55,43,2381,0,477,2282,2866
1273,Himachal Pradesh,2007,04. Molestation,142,3,263,102,23,21,266,0,67,32,1033,1037,322,263,165,0,0,1300,184,133,404,357,27,22,67,1513,2,211,1500,1857
1274,Jammu & Kashmir,2007,04. Molestation,364,23,973,88,30,74,996,0,88,172,3447,2956,986,973,394,0,0,3929,963,146,2306,2306,55,1,1,8885,0,1018,7743,10049
1275,Jharkhand,2007,04. Molestation,254,56,290,6,92,2,346,0,157,163,920,982,342,290,346,0,0,1272,221,6,402,352,78,137,153,858,34,299,811,1163
1276,Karnataka,2007,04. Molestation,1191,52,1664,227,67,181,1716,4,210,284,3756,3577,1828,1664,1258,0,1,5241,1722,348,2456,2442,105,217,151,4929,80,1827,4662,7104
1277,Kerala,2007,04. Molestation,1549,51,2463,435,165,151,2514,0,412,453,8200,7886,2624,2463,1714,0,0,10349,2070,498,2959,3049,228,558,466,9651,2,2298,9398,12447
1278,Lakshadweep,2007,04. Molestation,0,0,1,0,0,0,1,0,1,0,2,1,2,1,0,0,0,2,0,0,1,1,0,0,0,1,0,0,0,1
1279,Madhya Pradesh,2007,04. Molestation,1972,54,6697,2429,1451,25,6751,0,147,151,25774,24929,6772,6697,3423,0,0,31626,2852,3002,8053,8061,2058,20,12,31347,0,4910,31198,39259
1280,Maharashtra,2007,04. Molestation,1282,55,3079,357,176,62,3134,0,901,791,23864,22600,3306,3079,1458,0,0,25679,1704,443,3864,3725,206,669,802,29125,6,1910,27753,31478
1281,Manipur,2007,04. Molestation,1,26,0,0,0,0,26,0,111,67,7,8,70,0,1,0,0,8,2,0,47,0,0,26,38,8,35,2,10,10
1282,Meghalaya,2007,04. Molestation,6,2,25,1,4,0,27,0,73,55,149,135,45,25,10,0,0,160,9,1,24,15,7,37,41,140,5,16,142,157
1283,Mizoram,2007,04. Molestation,3,6,62,0,56,0,68,0,4,6,18,15,66,62,59,0,0,77,3,0,64,67,63,38,35,32,0,66,31,98
1284,Nagaland,2007,04. Molestation,0,1,5,0,5,0,6,0,3,1,4,4,8,5,5,0,0,9,0,3,10,9,8,2,3,4,0,8,6,15
1285,Odisha,2007,04. Molestation,770,43,2439,0,102,107,2482,1,862,677,11827,10260,2775,2439,872,0,0,12699,1880,0,3713,3699,277,263,277,17590,0,2157,16048,19747
1286,Puducherry,2007,04. Molestation,26,1,92,12,8,1,93,1,7,13,172,126,89,92,34,0,0,218,50,16,160,179,11,28,8,280,1,61,178,357
1287,Punjab,2007,04. Molestation,101,54,245,2,38,31,299,0,232,135,774,670,427,245,139,0,0,915,197,3,472,352,90,248,329,1387,39,287,1325,1677
1288,Rajasthan,2007,04. Molestation,647,15,1932,436,766,516,1947,0,31,17,8081,8004,2477,1932,1413,6,0,9930,739,607,2753,2748,1041,0,5,12131,0,1780,11770,14518
1289,Sikkim,2007,04. Molestation,6,0,9,3,0,0,9,0,55,51,0,0,13,9,6,0,0,9,6,3,11,9,0,5,5,32,2,6,32,41
1290,Tamil Nadu,2007,04. Molestation,767,23,1237,1,477,147,1260,1,284,152,2867,2875,1540,1237,1244,0,0,4112,1239,1,1945,1788,840,219,334,3989,42,2079,4281,6069
1291,Tripura,2007,04. Molestation,148,18,248,0,24,0,266,0,12,34,437,361,244,248,172,0,0,609,138,0,197,155,21,14,40,203,16,159,207,362
1292,Uttar Pradesh,2007,04. Molestation,615,120,2244,89,1164,143,2364,0,116,101,6814,6438,2522,2244,1779,0,0,8682,1019,135,3485,3212,1676,98,169,9740,202,2695,9358,12570
1293,Uttarakhand,2007,04. Molestation,40,13,130,10,90,6,143,0,4,7,383,393,146,130,130,0,0,523,33,29,306,239,136,10,48,592,29,169,551,790
1294,West Bengal,2007,04. Molestation,611,92,1585,6,87,2,1677,0,1502,900,8394,7513,2281,1585,698,0,0,9098,804,31,1712,1839,87,1161,956,8940,78,891,8023,9862
1295,Andaman & Nicobar Islands,2008,04. Molestation,4,3,21,0,0,0,24,0,5,5,149,132,24,21,4,0,0,153,4,0,32,35,0,10,7,192,0,4,161,196
1296,Andhra Pradesh,2008,04. Molestation,1538,131,3713,1417,520,742,3844,1,1394,1262,4983,4745,4730,3713,2058,0,11,8458,1895,1579,4922,4831,608,1639,1543,5882,187,2503,5133,9964
1297,Arunachal Pradesh,2008,04. Molestation,6,21,64,13,13,0,85,0,21,34,321,289,72,64,19,0,0,353,7,8,73,66,16,12,11,348,8,23,313,379
1298,Assam,2008,04. Molestation,454,245,731,33,78,92,976,0,757,553,1599,1433,1272,731,532,0,0,2164,605,102,1307,833,227,848,989,1895,333,832,1996,2829
1299,Bihar,2008,04. Molestation,385,95,684,68,76,65,779,0,512,357,2068,1913,999,684,461,0,0,2597,629,116,1165,1042,105,504,624,3352,3,734,3160,4202
1300,Chandigarh,2008,04. Molestation,15,4,23,0,1,0,27,0,8,16,75,68,19,23,16,0,0,91,21,0,22,30,1,22,12,95,2,22,87,117
1301,Chhattisgarh,2008,04. Molestation,449,23,1605,299,279,13,1628,3,51,74,7671,7093,1621,1605,728,0,0,8698,575,279,1934,1921,330,59,36,7755,36,905,7018,8939
1302,Dadra & Nagar Haveli,2008,04. Molestation,0,0,4,0,0,0,4,0,0,0,16,12,4,4,0,0,0,16,0,0,7,7,0,0,0,22,0,0,15,22
1303,Daman & Diu,2008,04. Molestation,1,0,1,1,0,0,1,0,1,0,3,4,2,1,1,0,0,5,1,3,1,1,0,0,0,4,0,1,7,8
1304,Delhi,2008,04. Molestation,141,13,715,0,184,4,728,2,352,475,3382,2992,611,715,325,0,0,3707,443,0,855,961,266,790,649,4510,35,709,4258,5219
1305,Goa,2008,04. Molestation,11,4,26,1,4,0,30,0,23,21,66,56,32,26,15,0,0,82,18,1,28,33,3,26,17,86,4,21,75,108
1306,Gujarat,2008,04. Molestation,472,16,800,88,48,3,816,1,66,58,6745,6553,828,800,520,0,0,7353,776,135,1291,1296,111,62,57,9428,0,887,9154,10450
1307,Haryana,2008,04. Molestation,258,5,385,7,97,37,390,0,33,25,1589,1566,435,385,355,0,0,1951,338,8,533,540,131,43,36,2444,0,469,2381,2921
1308,Himachal Pradesh,2008,04. Molestation,122,1,275,58,30,22,276,0,64,67,1098,1033,295,275,152,0,0,1308,169,67,358,378,44,67,47,1611,0,213,1513,1891
1309,Jammu & Kashmir,2008,04. Molestation,349,4,781,95,11,44,785,0,194,88,3773,3447,935,781,360,0,0,4228,699,255,1748,1748,57,1,1,9622,0,756,8885,10633
1310,Jharkhand,2008,04. Molestation,193,22,235,12,43,3,257,0,168,157,907,920,271,235,236,0,0,1155,290,23,302,362,51,153,87,856,6,341,858,1220
1311,Karnataka,2008,04. Molestation,1006,79,1722,394,93,82,1801,7,273,210,3985,3756,1954,1722,1099,0,1,5478,1534,647,2927,2751,110,151,281,5389,46,1644,4929,7680
1312,Kerala,2008,04. Molestation,1315,67,2441,378,184,192,2508,0,457,412,8764,8200,2745,2441,1499,0,0,10641,1916,514,3452,3504,258,466,414,10467,0,2174,9651,13155
1313,Lakshadweep,2008,04. Molestation,0,1,0,0,0,0,1,0,0,1,2,2,0,0,0,0,0,2,0,0,0,0,0,0,0,1,0,0,1,1
1314,Madhya Pradesh,2008,04. Molestation,2673,30,6372,2236,1971,15,6402,0,175,147,25265,25774,6445,6372,4644,1,0,32145,2828,2745,7686,7683,2898,12,15,30559,0,5726,31347,39030
1315,Maharashtra,2008,04. Molestation,1438,82,3340,447,180,46,3422,0,1052,901,25139,23864,3619,3340,1618,0,0,27204,1965,522,4334,4253,205,802,866,30686,17,2170,29125,33378
1316,Manipur,2008,04. Molestation,0,15,0,0,0,0,15,0,153,111,7,7,57,0,0,0,0,7,0,0,47,0,0,38,25,8,60,0,8,8
1317,Meghalaya,2008,04. Molestation,11,7,24,2,12,0,31,0,96,73,148,149,54,24,23,0,0,173,16,2,18,19,11,41,38,130,2,27,140,159
1318,Mizoram,2008,04. Molestation,8,2,71,0,38,0,73,0,9,4,43,18,78,71,46,0,0,89,8,0,76,71,40,35,40,55,0,48,32,103
1319,Nagaland,2008,04. Molestation,1,1,10,0,3,0,11,0,7,3,10,4,15,10,4,0,0,14,1,0,22,14,5,3,5,12,6,6,4,18
1320,Odisha,2008,04. Molestation,1146,55,2342,0,109,122,2397,0,1125,862,12914,11827,2782,2342,1255,0,0,14169,2445,0,3765,3746,383,277,296,18508,0,2828,17590,21336
1321,Puducherry,2008,04. Molestation,19,2,65,3,7,2,67,0,3,7,208,172,65,65,26,0,0,237,32,3,85,92,9,8,1,328,0,41,280,372
1322,Punjab,2008,04. Molestation,148,61,265,0,73,66,326,0,228,232,818,774,388,265,221,0,0,1039,229,0,512,458,112,329,328,1504,55,341,1387,1845
1323,Rajasthan,2008,04. Molestation,527,7,1964,391,825,557,1971,0,23,31,8302,8081,2520,1964,1352,0,0,10045,787,575,2893,2898,1076,5,0,12591,0,1863,12131,15029
1324,Sikkim,2008,04. Molestation,3,4,16,2,3,0,20,0,54,55,8,0,19,16,6,0,0,16,19,0,18,20,3,5,3,30,0,22,32,52
1325,Tamil Nadu,2008,04. Molestation,632,80,1363,0,338,217,1443,0,329,284,3260,2867,1705,1363,970,0,0,4230,947,2,2220,2059,543,334,428,4556,67,1490,3989,6048
1326,Tripura,2008,04. Molestation,81,35,291,6,17,3,326,0,29,12,624,437,346,291,98,0,0,728,145,4,349,312,18,40,31,348,46,163,203,515
1327,Uttar Pradesh,2008,04. Molestation,852,171,2599,105,1502,193,2770,0,108,116,6954,6814,2955,2599,2354,0,0,9413,1307,161,4109,3723,2277,169,172,9718,383,3584,9740,13463
1328,Uttarakhand,2008,04. Molestation,17,9,99,22,72,5,108,0,11,4,371,383,120,99,89,0,0,482,38,36,160,177,123,48,5,572,26,161,592,769
1329,West Bengal,2008,04. Molestation,601,93,1566,16,95,4,1659,0,2235,1502,9248,8394,2396,1566,696,0,0,9960,719,18,1584,1567,93,956,924,9677,49,812,8940,10507
1330,Andaman & Nicobar Islands,2009,04. Molestation,6,2,27,0,0,0,29,0,6,5,170,149,30,27,6,0,0,176,8,0,40,36,0,7,11,220,0,8,192,228
1331,Andhra Pradesh,2009,04. Molestation,2024,242,4229,1368,253,841,4471,0,1229,1394,5567,4983,5147,4229,2277,0,0,9212,2627,1787,5441,5163,427,1543,1682,6204,139,3054,5882,11045
1332,Arunachal Pradesh,2009,04. Molestation,10,11,54,3,15,0,65,0,14,21,347,321,58,54,25,0,0,375,11,3,70,57,15,11,14,376,10,26,348,405
1333,Assam,2009,04. Molestation,441,284,767,43,111,109,1051,0,939,757,1771,1599,1342,767,552,0,0,2366,582,12,1614,1050,156,989,1050,2195,503,738,1895,2945
1334,Bihar,2009,04. Molestation,358,77,554,66,68,34,631,0,573,512,2130,2068,726,554,426,0,0,2622,573,76,795,721,95,624,696,3329,2,668,3352,4073
1335,Chandigarh,2009,04. Molestation,14,1,13,0,3,5,14,0,15,8,71,75,26,13,17,0,0,88,22,0,39,24,3,12,22,94,5,25,95,119
1336,Chhattisgarh,2009,04. Molestation,641,11,1566,232,291,6,1577,0,66,51,7767,7671,1598,1566,932,306,0,8931,738,268,1817,1790,307,36,55,8232,8,1045,7755,9545
1337,Dadra & Nagar Haveli,2009,04. Molestation,0,0,2,0,0,0,2,0,0,0,18,16,2,2,0,0,0,18,0,0,2,2,0,0,0,24,0,0,22,24
1338,Daman & Diu,2009,04. Molestation,0,1,0,0,0,0,1,0,4,1,3,3,4,0,0,0,0,3,0,0,5,0,0,0,5,4,0,0,4,4
1339,Delhi,2009,04. Molestation,213,39,515,0,200,5,554,0,345,352,3484,3382,552,515,413,0,0,3897,285,0,710,776,231,649,582,4770,1,516,4510,5286
1340,Goa,2009,04. Molestation,9,9,21,0,3,0,30,0,30,23,75,66,37,21,12,0,0,87,9,0,35,22,3,17,24,96,6,12,86,108
1341,Gujarat,2009,04. Molestation,438,13,707,37,39,4,720,0,69,66,6937,6745,727,707,477,1,0,7451,607,46,1025,1015,50,57,67,9740,0,657,9428,10443
1342,Haryana,2009,04. Molestation,229,2,403,3,90,38,405,0,41,33,1670,1589,451,403,319,0,0,1992,332,6,553,550,129,36,39,2527,0,461,2444,2994
1343,Himachal Pradesh,2009,04. Molestation,128,3,308,35,20,19,311,0,52,64,1223,1098,318,308,148,0,0,1406,171,62,345,354,34,47,38,1698,0,205,1611,1965
1344,Jammu & Kashmir,2009,04. Molestation,436,10,940,121,82,66,950,0,150,194,4074,3773,972,940,518,0,0,4713,884,208,2044,2043,217,1,2,10356,0,1101,9622,11665
1345,Jharkhand,2009,04. Molestation,199,20,237,16,67,4,257,0,183,168,862,907,276,237,266,0,0,1144,235,9,327,291,102,87,123,801,0,337,856,1147
1346,Karnataka,2009,04. Molestation,993,35,1855,327,71,92,1890,7,470,273,4449,3985,2186,1855,1064,0,0,5840,1727,471,3159,3032,91,281,303,6132,105,1818,5389,8421
1347,Kerala,2009,04. Molestation,1277,109,2358,254,166,154,2467,0,376,457,9425,8764,2540,2358,1443,0,0,11122,1729,330,3238,3293,234,414,359,11467,0,1963,10467,13760
1348,Lakshadweep,2009,04. Molestation,1,0,0,0,0,0,0,0,0,0,1,2,0,0,1,0,0,2,1,0,0,0,0,0,0,0,0,1,1,1
1349,Madhya Pradesh,2009,04. Molestation,2663,41,6331,2713,1566,11,6372,0,99,175,24654,25265,6307,6331,4229,0,0,31596,3452,3326,7567,7556,1941,15,26,29396,0,5393,30559,38115
1350,Maharashtra,2009,04. Molestation,1557,62,3114,437,157,30,3176,0,1042,1052,26102,25139,3196,3114,1714,0,0,28253,2013,524,3938,3826,191,866,966,31784,12,2204,30686,34512
1351,Manipur,2009,04. Molestation,0,14,2,0,0,0,16,0,176,153,9,7,39,2,0,0,0,9,0,0,40,2,0,25,37,10,26,0,8,10
1352,Meghalaya,2009,04. Molestation,13,26,45,0,3,0,71,0,97,96,177,148,72,45,16,0,0,193,8,0,42,65,3,38,11,184,4,11,130,195
1353,Mizoram,2009,04. Molestation,8,0,68,0,47,0,68,0,2,9,56,43,61,68,55,0,0,111,8,0,78,113,60,40,5,100,0,68,55,168
1354,Nagaland,2009,04. Molestation,1,1,11,0,8,0,12,0,6,7,12,10,11,11,9,0,0,21,1,0,13,10,9,5,6,12,2,10,12,22
1355,Odisha,2009,04. Molestation,805,37,2436,0,78,118,2473,1,1230,1125,14467,12914,2697,2436,883,0,0,15350,1563,0,3589,3534,120,296,351,20359,0,1683,18508,22042
1356,Puducherry,2009,04. Molestation,18,0,52,6,4,2,52,1,1,3,232,208,53,52,22,0,0,260,64,18,53,53,16,1,1,283,0,80,328,381
1357,Punjab,2009,04. Molestation,157,47,219,0,79,34,266,0,247,228,801,818,319,219,236,0,0,1037,208,0,355,315,104,328,350,1507,18,312,1504,1819
1358,Rajasthan,2009,04. Molestation,452,25,1893,368,633,574,1918,0,16,23,8742,8302,2485,1893,1085,0,0,10195,660,570,2692,2692,893,0,0,13160,0,1553,12591,15283
1359,Sikkim,2009,04. Molestation,2,25,32,13,6,0,57,0,7,54,19,8,10,32,8,0,0,40,10,32,36,32,8,3,7,12,0,18,30,62
1360,Tamil Nadu,2009,04. Molestation,691,47,1104,0,393,142,1151,0,278,329,3280,3260,1242,1104,1084,0,0,4364,1038,0,1916,1936,716,428,399,4738,9,1754,4556,6492
1361,Tripura,2009,04. Molestation,142,34,354,11,16,0,388,0,25,29,809,624,384,354,158,0,0,978,350,38,434,354,16,31,58,298,53,366,348,702
1362,Uttar Pradesh,2009,04. Molestation,655,138,2525,51,1568,156,2663,0,71,108,7205,6954,2782,2525,2223,0,0,9479,1054,67,4026,3656,2510,172,132,9743,410,3564,9718,13374
1363,Uttarakhand,2009,04. Molestation,25,14,108,3,90,2,122,0,6,11,361,371,119,108,115,0,0,479,77,6,178,172,173,5,11,488,0,250,572,744
1364,West Bengal,2009,04. Molestation,573,122,1740,15,85,5,1862,1,2309,2235,10315,9248,1942,1740,658,0,0,10988,807,116,1640,1602,100,924,874,10256,88,907,9677,11279
1365,Andaman & Nicobar Islands,2010,04. Molestation,3,3,24,0,0,0,27,0,10,6,191,170,31,24,3,0,0,194,5,0,40,34,0,11,17,249,0,5,220,254
1366,Andhra Pradesh,2010,04. Molestation,1925,53,3868,698,496,763,3921,5,1174,1229,6314,5567,4634,3868,2421,2,0,9433,2374,922,4622,4698,484,1682,1406,7122,200,2858,6204,10902
1367,Arunachal Pradesh,2010,04. Molestation,4,9,54,1,4,0,63,0,35,14,392,347,84,54,8,0,0,401,5,1,88,61,5,14,31,426,10,10,376,437
1368,Assam,2010,04. Molestation,376,302,892,26,73,57,1194,11,1077,939,2188,1771,1400,892,449,0,0,2663,559,46,2020,1090,138,1050,1413,2542,567,697,2195,3285
1369,Bihar,2010,04. Molestation,334,34,482,43,73,22,516,0,569,573,2162,2130,534,482,407,0,0,2612,506,77,808,676,109,696,761,3313,67,615,3329,4005
1370,Chandigarh,2010,04. Molestation,24,2,24,0,7,4,26,0,14,15,64,71,29,24,31,0,0,95,28,0,28,30,7,22,13,89,7,35,94,124
1371,Chhattisgarh,2010,04. Molestation,974,20,1650,251,409,4,1670,0,98,66,7783,7767,1706,1650,1383,0,0,9417,1126,266,1969,1960,512,55,56,8288,8,1638,8232,10192
1372,Dadra & Nagar Haveli,2010,04. Molestation,0,0,5,0,1,0,5,0,6,0,22,18,11,5,1,0,0,23,0,0,12,5,2,0,7,27,0,2,24,29
1373,Daman & Diu,2010,04. Molestation,1,0,3,1,0,0,3,0,3,4,4,3,2,3,1,0,0,6,2,1,2,1,0,5,6,2,0,2,4,5
1374,Delhi,2010,04. Molestation,246,12,572,0,169,3,584,0,359,345,3641,3484,601,572,415,0,0,4056,395,0,794,721,336,582,641,4760,14,731,4770,5491
1375,Goa,2010,04. Molestation,21,7,32,0,4,2,39,0,25,30,82,75,36,32,25,0,0,107,35,0,37,38,4,24,18,95,5,39,96,134
1376,Gujarat,2010,04. Molestation,420,15,659,28,22,1,674,0,62,69,7126,6937,668,659,442,0,0,7596,671,42,986,972,29,67,81,9970,0,700,9740,10712
1377,Haryana,2010,04. Molestation,270,9,415,0,117,54,424,0,39,41,1698,1670,476,415,387,0,0,2085,374,0,605,596,165,39,48,2584,0,539,2527,3123
1378,Himachal Pradesh,2010,04. Molestation,104,2,334,41,17,22,336,0,44,52,1395,1223,350,334,121,0,0,1557,152,65,418,421,27,38,35,1875,0,179,1698,2119
1379,Jammu & Kashmir,2010,04. Molestation,344,9,889,123,29,57,898,0,233,150,4467,4074,1038,889,373,0,0,4963,701,270,2053,2049,55,2,6,11379,0,756,10356,12405
1380,Jharkhand,2010,04. Molestation,268,28,221,6,49,9,249,0,170,183,760,862,245,221,317,0,0,1083,306,4,273,318,58,123,73,751,5,364,801,1119
1381,Karnataka,2010,04. Molestation,1154,75,2169,165,52,146,2244,5,619,470,5243,4449,2544,2169,1206,4,0,6614,1821,494,3411,3102,89,303,431,6830,181,1910,6132,9234
1382,Kerala,2010,04. Molestation,1213,36,2682,207,168,148,2718,0,446,376,10519,9425,2936,2682,1381,0,0,12107,1742,276,3585,3602,246,359,342,12805,0,1988,11467,15069
1383,Lakshadweep,2010,04. Molestation,0,0,0,0,0,0,0,0,0,0,1,1,0,0,0,0,0,1,0,0,0,0,0,0,0,0,0,0,0,0
1384,Madhya Pradesh,2010,04. Molestation,2981,30,6609,2705,1749,13,6639,0,93,99,23827,24654,6646,6609,4730,1,0,31262,3636,3302,7863,7838,2155,26,23,28141,28,5791,29396,37234
1385,Maharashtra,2010,04. Molestation,1755,59,3311,372,162,49,3370,0,1284,1042,27124,26102,3661,3311,1917,0,0,29413,2183,427,4386,4047,206,966,1298,33015,7,2389,31784,35831
1386,Manipur,2010,04. Molestation,0,13,0,0,0,0,13,0,194,176,9,9,31,0,0,0,0,9,0,0,23,0,0,37,43,10,17,0,10,10
1387,Meghalaya,2010,04. Molestation,9,4,33,4,3,0,37,0,108,97,194,177,48,33,12,0,0,210,10,3,29,27,4,11,12,194,1,14,184,211
1388,Mizoram,2010,04. Molestation,7,0,73,0,71,0,73,0,4,2,51,56,75,73,78,0,0,129,12,0,79,81,122,5,3,47,0,134,100,181
1389,Nagaland,2010,04. Molestation,1,3,12,0,9,0,15,0,4,6,14,12,13,12,10,0,0,24,7,2,15,11,1,6,2,13,8,8,12,23
1390,Odisha,2010,04. Molestation,1242,49,2719,0,98,173,2768,6,1188,1230,15846,14467,2905,2719,1340,0,0,17186,1876,0,4116,4265,147,351,202,22601,0,2023,20359,24624
1391,Puducherry,2010,04. Molestation,24,0,43,11,7,4,43,0,0,1,233,232,46,43,31,0,0,275,52,15,71,72,11,1,0,277,0,63,283,355
1392,Punjab,2010,04. Molestation,132,84,235,2,77,61,319,0,197,228,694,670,349,235,209,0,0,905,291,2,454,445,162,303,276,1283,36,453,1293,1738
1393,Rajasthan,2010,04. Molestation,523,17,1727,298,550,587,1744,0,24,16,9098,8742,2339,1727,1073,0,0,10469,599,459,2598,2598,804,0,0,13896,0,1403,13160,15758
1394,Sikkim,2010,04. Molestation,4,2,13,2,3,0,15,0,3,7,23,19,11,13,7,0,0,32,8,2,23,13,3,7,12,12,5,11,12,25
1395,Tamil Nadu,2010,04. Molestation,582,76,987,1,508,174,1063,0,446,278,3176,3280,1405,987,1090,0,0,4267,1008,0,1946,1598,765,399,732,4563,15,1773,4738,6336
1396,Tripura,2010,04. Molestation,151,34,308,23,22,6,342,0,53,25,921,809,376,308,173,0,0,1117,309,18,456,358,36,58,42,293,114,345,298,656
1397,Uttar Pradesh,2010,04. Molestation,734,119,2513,51,1818,133,2632,0,99,71,7115,7205,2793,2513,2552,0,0,9718,1137,71,4189,3646,2810,132,179,9371,496,3947,9743,13389
1398,Uttarakhand,2010,04. Molestation,11,7,116,2,51,4,123,0,4,6,413,361,125,116,62,0,0,477,16,9,184,183,65,11,6,581,6,81,488,671
1399,West Bengal,2010,04. Molestation,491,100,1915,17,81,4,2015,0,2755,2309,11641,10315,2465,1915,572,0,0,12230,706,21,1841,2167,91,874,490,11605,58,797,10256,12423
1400,Andaman & Nicobar Islands,2001,05. Sexual Harassment,0,0,1,0,0,0,1,0,0,0,5,4,1,1,0,0,0,5,0,0,1,1,0,0,0,6,0,0,5,6
1401,Andhra Pradesh,2001,05. Sexual Harassment,412,14,2011,200,1120,88,2025,6,503,351,1540,1266,2271,2011,1532,5,0,3272,734,268,2268,2068,1136,380,546,1894,34,1870,1964,4032
1402,Arunachal Pradesh,2001,05. Sexual Harassment,0,0,3,0,1,0,3,0,0,0,5,3,3,3,1,0,0,6,0,0,3,3,0,1,1,4,0,0,1,4
1403,Assam,2001,05. Sexual Harassment,4,2,3,0,2,0,5,0,22,23,38,41,4,3,6,0,0,44,7,0,11,7,3,11,13,31,2,10,34,41
1404,Bihar,2001,05. Sexual Harassment,17,4,17,2,8,0,21,0,14,14,71,81,21,17,25,0,0,98,32,4,37,42,8,76,61,112,10,40,114,156
1405,Chandigarh,2001,05. Sexual Harassment,3,1,13,0,5,0,14,0,3,2,22,17,15,13,8,0,0,30,7,0,17,19,6,4,2,29,0,13,23,42
1406,Chhattisgarh,2001,05. Sexual Harassment,55,3,166,46,87,0,169,0,0,8,778,800,161,166,142,0,0,966,72,53,194,210,89,16,0,1187,0,161,1191,1401
1407,Dadra & Nagar Haveli,2001,05. Sexual Harassment,0,0,0,0,0,0,0,0,0,0,1,1,0,0,0,0,0,1,0,0,0,0,0,0,0,1,0,0,1,1
1408,Daman & Diu,2001,05. Sexual Harassment,0,0,0,0,0,0,0,0,0,0,0,0,0,0,0,0,0,0,0,0,0,0,0,0,0,0,0,0,0,0
1409,Delhi,2001,05. Sexual Harassment,41,14,95,0,35,0,109,0,41,60,249,230,90,95,76,0,0,325,52,0,107,106,26,42,41,531,2,78,503,609
1410,Goa,2001,05. Sexual Harassment,9,2,6,1,1,0,8,0,3,4,20,25,7,6,10,0,0,31,12,1,8,6,1,3,5,24,0,13,32,38
1411,Gujarat,2001,05. Sexual Harassment,44,5,103,3,6,2,108,0,1,0,571,521,111,103,50,0,0,624,57,3,147,149,6,2,0,815,0,63,732,881
1412,Haryana,2001,05. Sexual Harassment,60,3,388,0,379,2,391,0,12,4,537,588,401,388,439,0,0,976,173,0,480,471,527,3,11,982,1,700,1211,1682
1413,Himachal Pradesh,2001,05. Sexual Harassment,7,0,15,7,2,2,15,0,1,4,76,77,14,15,9,0,0,92,17,8,18,19,2,1,0,152,0,19,160,179
1414,Jammu & Kashmir,2001,05. Sexual Harassment,167,5,293,16,70,3,298,0,38,51,622,582,288,293,237,0,0,875,193,13,367,360,68,1,1,982,7,261,896,1256
1415,Jharkhand,2001,05. Sexual Harassment,9,0,6,0,4,0,6,0,8,9,47,54,5,6,13,0,0,60,10,0,46,6,10,11,50,140,1,20,154,160
1416,Karnataka,2001,05. Sexual Harassment,19,1,60,4,11,21,61,22,7,30,159,133,81,60,30,0,0,193,57,2,71,72,11,5,4,116,0,68,114,186
1417,Kerala,2001,05. Sexual Harassment,47,2,76,7,6,2,78,0,9,8,176,160,81,76,53,0,0,236,56,8,127,102,3,8,32,261,1,59,226,328
1418,Lakshadweep,2001,05. Sexual Harassment,0,0,0,0,0,0,0,0,0,0,0,0,0,0,0,0,0,0,0,0,0,0,0,0,0,0,0,0,0,0
1419,Madhya Pradesh,2001,05. Sexual Harassment,207,57,649,23,204,0,706,0,37,23,1398,1219,751,649,411,36,31,1832,433,157,1123,1106,306,1,12,2549,6,739,2339,3445
1420,Maharashtra,2001,05. Sexual Harassment,372,19,1092,171,26,3,1111,0,159,153,5666,5143,1120,1092,398,0,0,6235,475,209,1314,1309,33,60,60,7185,5,508,6593,7902
1421,Manipur,2001,05. Sexual Harassment,0,0,0,0,0,0,0,0,0,0,0,0,0,0,0,0,0,0,0,0,0,0,0,0,0,0,0,0,0,0
1422,Meghalaya,2001,05. Sexual Harassment,0,1,0,0,0,0,1,0,13,14,3,3,0,0,0,0,0,3,0,0,0,0,0,0,0,1,0,0,1,1
1423,Mizoram,2001,05. Sexual Harassment,0,0,0,0,0,0,0,0,0,0,0,0,0,0,0,0,0,0,0,0,0,0,0,0,0,0,0,0,0,0
1424,Nagaland,2001,05. Sexual Harassment,0,0,0,0,0,0,0,0,0,0,0,0,0,0,0,0,0,0,0,0,0,0,0,0,0,0,0,0,0,0
1425,Odisha,2001,05. Sexual Harassment,136,23,434,0,57,0,457,0,45,44,593,352,458,434,193,0,0,786,398,0,539,541,45,7,5,619,0,443,521,1062
1426,Puducherry,2001,05. Sexual Harassment,4,1,27,7,16,0,28,0,0,1,21,21,27,27,20,0,0,48,7,16,45,45,20,0,0,26,0,27,24,69
1427,Punjab,2001,05. Sexual Harassment,2,6,33,1,1,7,39,1,15,15,46,17,47,33,3,0,0,50,5,0,57,43,1,23,35,57,2,6,20,63
1428,Rajasthan,2001,05. Sexual Harassment,12,1,51,12,35,5,52,0,0,1,182,190,56,51,47,0,0,241,31,16,58,58,41,0,0,289,0,72,319,377
1429,Sikkim,2001,05. Sexual Harassment,1,6,7,0,1,0,13,0,1,0,18,13,14,7,2,0,0,20,2,1,18,7,5,6,6,1,11,7,2,9
1430,Tamil Nadu,2001,05. Sexual Harassment,126,3,1055,0,989,2,1058,7,16,71,501,561,1012,1055,1115,0,0,1616,120,0,1229,1220,1051,40,24,658,25,1171,609,1829
1431,Tripura,2001,05. Sexual Harassment,0,0,0,0,0,0,0,0,0,0,0,0,0,0,0,0,0,0,0,0,0,0,0,0,0,0,0,0,0,0
1432,Uttar Pradesh,2001,05. Sexual Harassment,511,25,2593,59,1601,10,2618,0,66,119,4352,3930,2575,2593,2112,0,0,6523,780,91,3961,3969,2159,143,96,6778,39,2939,5839,9808
1433,Uttarakhand,2001,05. Sexual Harassment,24,5,86,1,48,0,91,0,2,9,153,140,84,86,72,0,0,226,57,2,137,132,108,5,4,211,6,165,246,378
1434,West Bengal,2001,05. Sexual Harassment,30,10,33,0,1,0,43,0,25,20,42,40,48,33,31,0,0,73,32,0,56,34,1,22,29,60,15,33,59,93
1435,Andaman & Nicobar Islands,2002,05. Sexual Harassment,0,0,3,0,0,0,3,0,0,0,8,5,3,3,0,0,0,8,0,0,3,3,0,0,0,9,0,0,6,9
1436,Andhra Pradesh,2002,05. Sexual Harassment,408,12,2165,192,1159,122,2177,2,226,503,1938,1540,2024,2165,1567,8,0,3697,595,192,2433,2146,1185,546,772,2068,61,1780,1894,4040
1437,Arunachal Pradesh,2002,05. Sexual Harassment,0,0,2,0,0,0,2,0,0,0,7,5,2,2,0,0,0,7,0,0,4,1,0,1,4,5,0,0,4,5
1438,Assam,2002,05. Sexual Harassment,6,6,5,0,0,0,11,0,18,22,37,38,7,5,6,0,0,43,5,0,7,5,0,13,13,31,2,5,31,36
1439,Bihar,2002,05. Sexual Harassment,16,0,11,0,4,0,11,0,9,14,62,71,6,11,20,0,0,82,22,0,16,50,4,61,27,146,0,26,122,172
1440,Chandigarh,2002,05. Sexual Harassment,5,2,27,0,13,0,29,0,2,3,31,22,28,27,18,0,0,49,7,0,31,33,13,2,0,42,0,20,29,62
1441,Chhattisgarh,2002,05. Sexual Harassment,151,0,147,89,157,0,147,0,0,0,530,780,147,147,308,0,0,927,258,97,177,167,313,0,10,686,0,571,1187,1354
1442,Dadra & Nagar Haveli,2002,05. Sexual Harassment,0,0,0,0,0,0,0,0,0,0,1,1,0,0,0,0,0,1,0,0,0,0,0,0,0,1,0,0,1,1
1443,Daman & Diu,2002,05. Sexual Harassment,0,0,0,0,0,0,0,0,0,0,1,1,0,0,0,0,0,1,0,0,0,0,0,0,0,0,0,0,0,0
1444,Delhi,2002,05. Sexual Harassment,18,3,110,0,34,0,113,0,56,41,307,249,128,110,52,0,0,359,34,0,171,112,41,41,98,568,2,75,531,643
1445,Goa,2002,05. Sexual Harassment,5,0,7,2,0,0,7,0,2,3,20,20,6,7,5,0,0,27,5,2,8,8,0,5,5,25,0,5,24,32
1446,Gujarat,2002,05. Sexual Harassment,51,4,96,1,6,2,100,0,3,1,609,571,104,96,57,0,0,667,73,2,142,139,4,0,3,875,0,77,815,954
1447,Haryana,2002,05. Sexual Harassment,143,2,1417,19,1196,4,1419,0,13,12,596,537,1424,1417,1339,0,0,1954,227,0,1612,1610,1331,11,13,1034,0,1558,982,2592
1448,Himachal Pradesh,2002,05. Sexual Harassment,4,0,9,5,0,1,9,0,3,1,76,76,12,9,4,0,0,85,9,4,16,14,0,0,2,153,0,9,152,166
1449,Jammu & Kashmir,2002,05. Sexual Harassment,199,2,345,6,113,9,347,0,50,38,649,622,368,345,312,0,0,967,244,5,458,452,146,1,7,1039,0,390,982,1434
1450,Jharkhand,2002,05. Sexual Harassment,12,0,3,0,3,0,3,0,6,6,39,51,3,3,15,0,0,54,12,0,3,16,0,18,3,140,2,12,136,152
1451,Karnataka,2002,05. Sexual Harassment,20,12,52,12,2,23,64,0,20,7,177,159,100,52,22,0,0,211,35,13,83,84,2,4,3,150,0,37,116,200
1452,Kerala,2002,05. Sexual Harassment,30,3,98,7,14,3,101,0,7,9,223,176,102,98,44,0,0,274,47,15,113,108,25,32,7,282,30,72,261,369
1453,Lakshadweep,2002,05. Sexual Harassment,0,0,0,0,0,0,0,0,0,0,0,0,0,0,0,0,0,0,0,0,0,0,0,0,0,0,0,0,0,0
1454,Madhya Pradesh,2002,05. Sexual Harassment,212,7,777,238,171,2,784,0,34,37,1554,1398,783,777,383,0,0,2175,277,319,1110,1114,273,12,8,2794,0,550,2549,3663
1455,Maharashtra,2002,05. Sexual Harassment,430,8,753,143,39,5,761,0,162,159,5807,5666,769,753,469,0,0,6419,754,187,972,969,40,60,58,7173,5,794,7185,8154
1456,Manipur,2002,05. Sexual Harassment,0,0,0,0,0,0,0,0,0,0,0,0,0,0,0,0,0,0,0,0,0,0,0,0,0,0,0,0,0,0
1457,Meghalaya,2002,05. Sexual Harassment,0,0,0,0,0,0,0,0,13,13,3,3,0,0,0,0,0,3,0,0,0,0,0,0,0,1,0,0,1,1
1458,Mizoram,2002,05. Sexual Harassment,0,0,0,0,0,0,0,0,0,0,0,0,0,0,0,0,0,0,0,0,1,1,1,0,0,0,0,1,0,1
1459,Nagaland,2002,05. Sexual Harassment,0,0,0,0,0,0,0,0,0,0,0,0,0,0,0,0,0,0,0,0,0,0,0,0,0,0,0,0,0,0
1460,Odisha,2002,05. Sexual Harassment,93,6,182,2,15,2,188,0,43,45,665,593,188,182,108,0,0,775,157,0,244,247,18,5,2,691,0,175,619,866
1461,Puducherry,2002,05. Sexual Harassment,0,0,25,5,15,0,25,0,1,0,26,21,26,25,15,0,0,46,0,6,35,33,22,0,2,31,0,22,26,59
1462,Punjab,2002,05. Sexual Harassment,21,13,126,0,75,6,139,1,14,15,76,46,145,126,96,0,0,172,32,0,185,167,92,35,37,100,16,124,57,224
1463,Rajasthan,2002,05. Sexual Harassment,18,0,37,22,34,7,37,0,0,0,145,182,44,37,52,0,0,219,28,26,62,62,62,0,0,235,0,90,289,351
1464,Sikkim,2002,05. Sexual Harassment,2,0,1,6,6,0,1,0,0,1,5,18,0,1,8,0,0,19,2,0,0,3,2,6,3,0,0,4,1,4
1465,Tamil Nadu,2002,05. Sexual Harassment,136,0,1686,0,1488,10,1686,0,38,16,563,501,1718,1686,1624,0,0,2187,189,8,1857,1859,1631,24,21,689,1,1820,658,2517
1466,Tripura,2002,05. Sexual Harassment,0,0,0,0,0,0,0,0,0,0,0,0,0,0,0,0,0,0,0,0,0,0,0,0,0,0,0,0,0,0
1467,Uttar Pradesh,2002,05. Sexual Harassment,745,15,1924,44,1431,10,1939,0,4,66,4056,4352,1887,1924,2176,0,0,6276,1463,67,2771,2840,2035,96,8,6053,19,3498,6778,9618
1468,Uttarakhand,2002,05. Sexual Harassment,16,0,99,0,50,0,99,0,0,2,186,153,97,99,66,0,0,252,17,0,135,138,71,4,0,261,1,88,211,349
1469,West Bengal,2002,05. Sexual Harassment,42,4,31,0,2,0,35,0,24,25,29,42,34,31,44,0,0,73,37,0,49,47,3,29,29,67,2,40,60,107
1470,Andaman & Nicobar Islands,2003,05. Sexual Harassment,0,0,2,0,0,0,2,0,0,0,10,8,2,2,0,0,0,10,0,0,2,2,0,0,0,11,0,0,9,11
1471,Andhra Pradesh,2003,05. Sexual Harassment,794,18,2049,233,1357,124,2067,19,302,226,1603,1938,2286,2049,2151,0,0,3987,1031,394,3066,2978,1068,772,770,2553,90,2099,2068,5046
1472,Arunachal Pradesh,2003,05. Sexual Harassment,0,0,0,0,0,0,0,0,0,0,7,7,0,0,0,0,0,7,0,0,0,0,0,4,4,5,0,0,5,5
1473,Assam,2003,05. Sexual Harassment,15,4,4,0,2,1,8,0,15,18,24,37,6,4,17,0,0,41,14,0,6,5,0,13,5,22,9,14,31,36
1474,Bihar,2003,05. Sexual Harassment,18,0,8,2,11,1,8,0,11,9,39,62,11,8,29,0,0,70,62,2,20,37,13,27,10,106,0,75,146,183
1475,Chandigarh,2003,05. Sexual Harassment,4,0,3,0,4,1,3,0,2,2,26,31,4,3,8,0,0,34,7,0,3,1,4,0,1,32,1,11,42,43
1476,Chhattisgarh,2003,05. Sexual Harassment,21,1,104,105,35,0,105,0,1,1,464,521,105,104,56,0,0,625,59,115,155,152,73,10,13,668,0,132,763,915
1477,Dadra & Nagar Haveli,2003,05. Sexual Harassment,0,0,0,0,0,0,0,0,0,0,1,1,0,0,0,0,0,1,0,0,0,0,0,0,0,1,0,0,1,1
1478,Daman & Diu,2003,05. Sexual Harassment,0,0,0,0,0,0,0,0,0,0,1,1,0,0,0,0,0,1,0,0,0,0,0,0,0,0,0,0,0,0
1479,Delhi,2003,05. Sexual Harassment,19,7,109,0,53,0,116,0,45,56,344,307,105,109,72,0,0,416,44,0,113,143,104,98,68,563,0,148,568,711
1480,Goa,2003,05. Sexual Harassment,4,0,5,1,1,0,5,0,4,2,19,20,7,5,5,0,0,25,7,1,6,8,1,5,3,24,0,8,25,33
1481,Gujarat,2003,05. Sexual Harassment,45,7,79,4,8,2,86,0,7,3,631,609,92,79,53,0,0,688,62,4,111,109,11,3,5,907,0,73,875,984
1482,Haryana,2003,05. Sexual Harassment,121,3,1309,0,1119,3,1312,0,0,13,665,596,1302,1309,1240,0,0,1905,202,0,1347,1360,1215,13,0,977,0,1417,1034,2394
1483,Himachal Pradesh,2003,05. Sexual Harassment,10,0,17,1,1,1,17,0,3,3,81,76,18,17,11,0,0,93,26,1,18,18,1,2,1,143,1,27,153,171
1484,Jammu & Kashmir,2003,05. Sexual Harassment,144,2,376,1,137,9,378,0,39,50,743,649,376,376,281,0,0,1025,160,3,471,473,180,7,5,1169,0,340,1039,1512
1485,Jharkhand,2003,05. Sexual Harassment,13,0,2,3,0,0,2,0,6,6,25,39,2,2,13,0,0,41,1,3,29,27,4,3,5,159,0,5,140,167
1486,Karnataka,2003,05. Sexual Harassment,28,6,57,6,18,14,63,0,27,20,182,177,84,57,46,0,0,234,45,19,57,53,17,3,7,122,0,62,150,203
1487,Kerala,2003,05. Sexual Harassment,39,3,61,12,11,3,64,0,8,7,222,223,68,61,50,0,0,284,45,24,222,178,15,7,51,376,0,60,282,460
1488,Lakshadweep,2003,05. Sexual Harassment,0,0,0,0,0,0,0,0,0,0,0,0,0,0,0,0,0,0,0,0,0,0,0,0,0,0,0,0,0,0
1489,Madhya Pradesh,2003,05. Sexual Harassment,311,4,699,188,229,0,703,0,9,7,1510,1539,705,699,540,0,0,2238,401,229,907,908,279,1,0,2876,0,680,2877,3785
1490,Maharashtra,2003,05. Sexual Harassment,468,15,669,190,38,6,684,0,154,162,5780,5807,682,669,506,0,0,6476,532,234,951,917,41,58,92,7283,0,573,7173,8090
1491,Manipur,2003,05. Sexual Harassment,0,0,0,0,0,0,0,0,0,0,0,0,0,0,0,0,0,0,0,0,0,0,0,0,0,0,0,0,0,0
1492,Meghalaya,2003,05. Sexual Harassment,0,1,0,0,0,0,1,0,13,13,3,3,1,0,0,0,0,3,0,0,1,0,0,0,0,1,1,0,1,1
1493,Mizoram,2003,05. Sexual Harassment,0,0,0,0,0,0,0,0,0,0,0,0,0,0,0,0,0,0,0,0,0,0,0,0,0,0,0,0,0,0
1494,Nagaland,2003,05. Sexual Harassment,0,0,2,2,0,0,2,0,0,0,0,0,2,2,0,0,0,2,0,2,5,2,0,0,0,0,3,0,0,2
1495,Odisha,2003,05. Sexual Harassment,192,1,212,0,36,3,213,0,15,43,649,665,188,212,228,0,0,877,161,0,299,299,52,2,2,777,0,213,691,990
1496,Puducherry,2003,05. Sexual Harassment,8,1,25,2,6,0,26,0,2,1,35,26,27,25,14,0,0,51,13,5,43,44,16,2,1,41,0,29,31,75
1497,Punjab,2003,05. Sexual Harassment,27,50,141,1,51,8,191,1,13,14,138,76,199,141,78,0,0,217,46,0,225,170,62,37,43,162,49,108,100,270
1498,Rajasthan,2003,05. Sexual Harassment,8,2,24,8,13,7,26,0,0,0,140,145,33,24,21,0,0,169,42,38,33,33,51,0,0,137,0,93,235,268
1499,Sikkim,2003,05. Sexual Harassment,3,0,0,2,0,0,0,0,0,0,0,5,0,0,3,0,0,5,3,0,0,3,0,3,0,0,0,3,0,3
1500,Tamil Nadu,2003,05. Sexual Harassment,163,1,872,1,474,7,873,1,37,37,794,568,881,872,637,8,0,1432,174,1,884,822,525,21,82,820,1,699,698,1520
1501,Tripura,2003,05. Sexual Harassment,0,0,0,0,0,0,0,0,0,0,0,0,0,0,0,0,0,0,0,0,0,0,0,0,0,0,0,0,0,0
1502,Uttar Pradesh,2003,05. Sexual Harassment,1039,1,4958,73,2321,4,4959,0,11,4,5581,4056,4970,4958,3360,0,0,9014,1317,119,6126,6113,2904,8,19,7826,2,4221,6053,12166
1503,Uttarakhand,2003,05. Sexual Harassment,24,1,96,13,79,0,97,0,1,0,166,186,98,96,103,0,0,282,32,25,167,164,118,0,1,250,2,150,261,425
1504,West Bengal,2003,05. Sexual Harassment,28,11,46,0,6,2,57,0,36,24,41,29,71,46,34,0,0,75,43,0,84,62,7,29,30,79,21,50,67,129
1505,Andaman & Nicobar Islands,2004,05. Sexual Harassment,1,0,2,0,0,0,2,0,1,0,11,10,3,2,1,0,0,12,1,0,3,2,0,0,1,12,0,1,11,13
1506,Andhra Pradesh,2004,05. Sexual Harassment,745,54,2043,276,739,112,2097,0,403,302,1885,1603,2310,2043,1484,1,0,3645,829,403,2528,2345,1135,770,850,2531,103,1964,2553,4898
1507,Arunachal Pradesh,2004,05. Sexual Harassment,0,0,0,0,0,0,0,0,0,0,7,7,0,0,0,0,0,7,0,0,0,4,0,4,0,9,0,0,5,9
1508,Assam,2004,05. Sexual Harassment,10,11,7,0,2,1,18,0,7,15,19,24,11,7,12,0,0,31,9,0,19,15,2,5,6,26,3,11,22,37
1509,Bihar,2004,05. Sexual Harassment,9,1,13,3,3,0,14,0,10,11,37,39,13,13,12,0,0,52,21,46,18,21,4,10,1,56,6,25,106,127
1510,Chandigarh,2004,05. Sexual Harassment,5,0,15,0,4,0,15,0,5,2,32,26,18,15,9,0,0,41,8,0,24,15,4,1,10,35,0,12,32,47
1511,Chhattisgarh,2004,05. Sexual Harassment,147,1,129,38,80,0,130,0,2,1,328,464,131,129,227,0,0,593,174,74,155,156,93,13,2,483,10,267,668,824
1512,Dadra & Nagar Haveli,2004,05. Sexual Harassment,0,0,0,0,0,0,0,0,0,0,1,1,0,0,0,0,0,1,0,0,0,0,0,0,0,1,0,0,1,1
1513,Daman & Diu,2004,05. Sexual Harassment,0,0,0,0,0,0,0,0,0,0,1,1,0,0,0,0,0,1,0,0,0,0,0,0,0,0,0,0,0,0
1514,Delhi,2004,05. Sexual Harassment,50,0,129,0,40,0,129,0,46,45,383,344,130,129,90,0,0,473,50,0,137,129,40,68,72,602,4,90,563,692
1515,Goa,2004,05. Sexual Harassment,4,1,8,2,0,0,9,0,10,4,21,19,15,8,4,0,0,27,5,3,17,10,0,3,10,26,0,5,24,34
1516,Gujarat,2004,05. Sexual Harassment,47,9,154,2,13,1,163,0,7,7,723,631,164,154,60,0,0,785,50,3,251,253,16,5,3,1091,0,66,907,1160
1517,Haryana,2004,05. Sexual Harassment,192,0,829,0,833,4,829,0,17,0,469,665,850,829,1025,0,0,1494,172,0,959,938,904,0,21,839,0,1076,977,1915
1518,Himachal Pradesh,2004,05. Sexual Harassment,9,1,14,13,1,2,15,0,2,3,72,81,16,14,10,0,0,95,4,16,17,16,4,1,2,135,0,8,143,159
1519,Jammu & Kashmir,2004,05. Sexual Harassment,173,2,251,1,80,2,253,0,48,39,740,743,264,251,253,0,0,994,231,0,319,319,107,5,5,1150,0,338,1169,1488
1520,Jharkhand,2004,05. Sexual Harassment,13,0,2,3,0,0,2,0,7,6,11,25,3,2,13,0,0,27,1,3,29,27,4,5,7,178,0,5,159,186
1521,Karnataka,2004,05. Sexual Harassment,51,8,62,4,70,3,70,0,11,27,119,182,57,62,121,0,0,244,49,4,63,69,47,7,1,91,0,96,122,191
1522,Kerala,2004,05. Sexual Harassment,57,0,115,18,20,5,115,0,21,8,242,222,133,115,77,0,0,337,93,21,148,92,18,51,107,336,0,111,376,468
1523,Lakshadweep,2004,05. Sexual Harassment,0,0,0,0,0,0,0,0,0,0,0,0,0,0,0,0,0,0,0,0,0,0,0,0,0,0,0,0,0,0
1524,Madhya Pradesh,2004,05. Sexual Harassment,254,3,785,173,205,4,788,0,21,9,1663,1510,804,785,459,0,0,2295,396,227,1032,1031,273,0,1,3011,0,669,2876,3907
1525,Maharashtra,2004,05. Sexual Harassment,281,13,775,103,13,4,788,0,224,154,6158,5780,862,775,294,0,0,6555,419,127,1092,1060,14,92,121,7783,3,433,7283,8343
1526,Manipur,2004,05. Sexual Harassment,0,0,0,0,0,0,0,0,0,0,0,0,0,0,0,0,0,0,0,0,0,0,0,0,0,0,0,0,0,0
1527,Meghalaya,2004,05. Sexual Harassment,0,0,0,0,0,0,0,0,13,13,3,3,0,0,0,0,0,3,0,0,0,0,0,0,0,1,0,0,1,1
1528,Mizoram,2004,05. Sexual Harassment,0,0,0,0,0,0,0,0,0,0,0,0,0,0,0,0,0,0,0,0,0,0,0,0,0,0,0,0,0,0
1529,Nagaland,2004,05. Sexual Harassment,0,0,0,0,0,0,0,0,1,0,0,0,1,0,0,0,0,0,0,0,0,0,0,0,0,0,0,0,0,0
1530,Odisha,2004,05. Sexual Harassment,114,1,161,0,24,4,162,0,19,15,672,649,170,161,138,0,0,810,134,0,255,248,31,2,9,860,0,165,777,1025
1531,Puducherry,2004,05. Sexual Harassment,4,0,30,4,8,1,30,0,1,2,49,35,30,30,12,0,0,65,7,11,41,42,10,1,0,55,0,17,41,83
1532,Punjab,2004,05. Sexual Harassment,25,8,32,1,61,1,40,1,9,13,83,138,38,32,86,0,0,170,28,5,43,64,66,43,8,127,14,94,162,226
1533,Rajasthan,2004,05. Sexual Harassment,17,0,35,6,28,6,35,0,0,0,124,140,41,35,45,0,0,175,24,7,51,51,31,0,0,126,0,55,137,188
1534,Sikkim,2004,05. Sexual Harassment,0,0,0,0,0,0,0,0,0,0,0,0,0,0,0,0,0,0,0,0,0,0,0,0,0,0,0,0,0,0
1535,Tamil Nadu,2004,05. Sexual Harassment,255,10,943,3,704,50,953,2,113,37,775,794,1081,943,959,0,0,1737,284,4,1037,1071,696,82,45,907,3,980,820,1891
1536,Tripura,2004,05. Sexual Harassment,0,0,0,0,0,0,0,0,0,0,0,0,0,0,0,0,0,0,0,0,0,0,0,0,0,0,0,0,0,0
1537,Uttar Pradesh,2004,05. Sexual Harassment,666,21,2644,52,1849,19,2665,0,9,11,5658,5581,2682,2644,2515,0,0,8225,875,70,4176,4159,2351,19,15,8689,21,3226,7826,11985
1538,Uttarakhand,2004,05. Sexual Harassment,3,0,109,0,48,1,109,0,1,1,224,166,110,109,51,0,0,275,5,0,267,258,60,1,7,443,3,65,250,508
1539,West Bengal,2004,05. Sexual Harassment,21,8,42,0,3,0,50,0,50,36,59,41,64,42,24,0,0,83,36,0,90,64,3,30,55,104,1,39,79,143
1540,Andaman & Nicobar Islands,2005,05. Sexual Harassment,1,0,1,0,0,0,1,0,1,1,11,11,1,1,1,0,0,12,3,0,3,2,0,1,2,11,0,3,12,14
1541,Andhra Pradesh,2005,05. Sexual Harassment,994,46,2410,369,1030,97,2456,0,358,403,1902,1885,2508,2410,2024,0,0,4295,1234,347,2963,2856,1214,850,894,2592,63,2448,2531,5387
1542,Arunachal Pradesh,2005,05. Sexual Harassment,0,0,0,0,0,0,0,0,0,0,7,7,0,0,0,0,0,7,0,0,0,0,0,0,0,9,0,0,9,9
1543,Assam,2005,05. Sexual Harassment,18,8,14,0,1,0,22,0,4,7,14,19,19,14,19,0,0,33,17,0,9,6,1,6,4,14,5,18,26,32
1544,Bihar,2005,05. Sexual Harassment,14,1,12,0,1,0,13,0,10,10,34,37,13,12,15,0,0,49,20,0,27,18,1,1,7,53,3,21,56,74
1545,Chandigarh,2005,05. Sexual Harassment,1,2,10,0,1,0,12,0,2,5,40,32,9,10,2,0,0,42,1,0,13,21,2,10,2,53,0,3,35,56
1546,Chhattisgarh,2005,05. Sexual Harassment,75,5,128,10,40,0,133,0,1,2,331,328,132,128,115,0,0,456,95,18,173,175,50,2,0,495,0,145,483,658
1547,Dadra & Nagar Haveli,2005,05. Sexual Harassment,0,0,0,0,0,0,0,0,0,0,1,1,0,0,0,0,0,1,0,0,0,0,0,0,0,1,0,0,1,1
1548,Daman & Diu,2005,05. Sexual Harassment,0,0,0,0,0,0,0,0,0,0,1,1,0,0,0,0,0,1,0,0,0,0,0,0,0,0,0,0,0,0
1549,Delhi,2005,05. Sexual Harassment,98,5,219,0,18,0,224,0,47,46,486,383,225,219,116,0,0,602,124,0,255,221,35,72,90,664,16,159,602,823
1550,Goa,2005,05. Sexual Harassment,2,5,9,4,0,0,14,0,4,10,24,21,8,9,2,0,0,30,3,8,9,10,0,10,3,25,6,3,26,36
1551,Gujarat,2005,05. Sexual Harassment,46,7,89,5,12,7,96,0,8,7,749,723,104,89,58,0,0,812,58,7,125,125,13,3,1,1138,2,71,1091,1216
1552,Haryana,2005,05. Sexual Harassment,80,2,587,0,343,8,589,0,17,17,633,469,597,587,423,0,0,1056,107,0,755,768,392,21,8,1108,0,499,839,1607
1553,Himachal Pradesh,2005,05. Sexual Harassment,13,1,27,2,3,1,28,0,2,2,81,72,29,27,16,0,0,99,15,2,34,35,4,2,1,149,0,19,135,170
1554,Jammu & Kashmir,2005,05. Sexual Harassment,175,3,343,0,74,5,346,0,68,48,834,740,371,343,249,0,0,1083,216,2,442,400,92,5,2,1240,45,308,1150,1550
1555,Jharkhand,2005,05. Sexual Harassment,11,7,24,13,7,1,31,0,11,7,4,11,36,24,18,0,0,35,34,0,88,21,11,7,46,154,28,45,178,199
1556,Karnataka,2005,05. Sexual Harassment,56,1,39,5,3,2,40,0,40,11,94,119,71,39,59,0,0,158,35,5,53,51,2,1,2,100,1,37,91,142
1557,Kerala,2005,05. Sexual Harassment,58,1,165,7,21,4,166,0,26,21,321,242,175,165,79,0,0,407,160,15,198,282,45,107,23,398,0,205,336,618
1558,Lakshadweep,2005,05. Sexual Harassment,0,0,0,0,0,0,0,0,0,0,0,0,0,0,0,0,0,0,0,0,0,0,0,0,0,0,0,0,0,0
1559,Madhya Pradesh,2005,05. Sexual Harassment,314,3,680,175,189,2,683,0,128,21,1662,1663,792,680,503,3,0,2340,387,207,878,876,254,1,3,3039,0,641,3011,3887
1560,Maharashtra,2005,05. Sexual Harassment,381,15,901,89,35,6,916,0,221,224,6554,6158,919,901,416,0,0,7059,502,129,1256,1229,39,121,145,8342,3,541,7783,9012
1561,Manipur,2005,05. Sexual Harassment,0,0,0,0,0,0,0,0,0,0,0,0,0,0,0,0,0,0,0,0,0,0,0,0,0,0,0,0,0,0
1562,Meghalaya,2005,05. Sexual Harassment,0,0,0,0,0,0,0,0,13,13,3,3,0,0,0,0,0,3,0,0,0,0,0,0,0,1,0,0,1,1
1563,Mizoram,2005,05. Sexual Harassment,0,0,1,0,0,0,1,0,3,0,1,0,4,1,0,0,0,1,0,0,6,3,2,0,3,1,0,2,0,3
1564,Nagaland,2005,05. Sexual Harassment,0,1,0,0,0,0,1,0,0,1,0,0,0,0,0,0,0,0,0,0,0,0,0,0,0,0,0,0,0,0
1565,Odisha,2005,05. Sexual Harassment,116,1,166,0,11,6,167,0,30,19,711,672,184,166,127,0,0,838,85,0,293,293,12,9,9,1056,0,97,860,1153
1566,Puducherry,2005,05. Sexual Harassment,10,0,27,5,14,0,27,0,0,1,47,49,26,27,24,0,0,76,12,6,30,30,14,0,0,53,0,26,55,85
1567,Punjab,2005,05. Sexual Harassment,16,9,18,0,6,7,27,0,18,9,79,83,43,18,22,0,0,101,22,0,42,27,7,8,12,125,11,29,127,154
1568,Rajasthan,2005,05. Sexual Harassment,11,0,22,2,17,6,22,0,0,0,116,124,28,22,28,0,0,146,17,3,38,38,19,0,0,125,0,36,126,164
1569,Sikkim,2005,05. Sexual Harassment,0,0,0,0,0,0,0,0,0,0,0,0,0,0,0,0,0,0,0,0,0,0,0,0,0,0,0,0,0,0
1570,Tamil Nadu,2005,05. Sexual Harassment,396,2,749,4,419,10,751,1,16,113,705,775,665,749,815,0,0,1524,341,0,787,809,446,45,20,929,3,787,907,1716
1571,Tripura,2005,05. Sexual Harassment,1,0,1,0,0,0,1,0,0,0,0,0,1,1,1,0,0,1,1,0,1,1,0,0,0,0,0,1,0,1
1572,Uttar Pradesh,2005,05. Sexual Harassment,630,3,2841,59,1834,6,2844,0,40,9,5976,5658,2881,2841,2464,0,0,8499,983,86,4469,4373,2908,15,65,9085,46,3891,8689,13062
1573,Uttarakhand,2005,05. Sexual Harassment,21,0,88,0,30,1,88,0,1,1,261,224,89,88,51,0,0,312,22,0,179,184,41,7,2,564,0,63,443,627
1574,West Bengal,2005,05. Sexual Harassment,29,11,52,0,3,0,63,0,41,50,79,59,54,52,32,0,0,111,42,0,66,65,3,55,40,124,16,45,104,169
1575,Andaman & Nicobar Islands,2006,05. Sexual Harassment,1,1,4,0,0,0,5,0,0,1,14,11,4,4,1,0,0,15,1,0,6,8,0,2,0,18,0,1,11,19
1576,Andhra Pradesh,2006,05. Sexual Harassment,737,40,2090,435,655,129,2130,0,510,358,2165,1902,2411,2090,1392,0,0,3992,1148,614,2816,2790,759,894,868,2861,52,1907,2592,5382
1577,Arunachal Pradesh,2006,05. Sexual Harassment,2,0,1,0,0,0,1,0,1,0,6,7,2,1,2,0,0,8,3,0,2,1,0,0,1,7,0,3,9,10
1578,Assam,2006,05. Sexual Harassment,8,2,8,0,1,0,10,0,4,4,13,14,10,8,9,0,0,22,6,0,10,8,0,4,4,16,2,6,14,22
1579,Bihar,2006,05. Sexual Harassment,23,7,43,1,5,7,50,0,6,10,48,34,53,43,28,0,0,77,27,0,55,47,10,7,15,63,0,37,53,100
1580,Chandigarh,2006,05. Sexual Harassment,1,0,12,0,3,1,12,0,2,2,48,40,13,12,4,0,0,52,1,0,20,20,3,2,2,69,0,4,53,73
1581,Chhattisgarh,2006,05. Sexual Harassment,51,3,135,19,27,0,138,0,6,1,369,331,143,135,78,0,0,466,62,19,179,178,41,0,1,551,0,103,495,673
1582,Dadra & Nagar Haveli,2006,05. Sexual Harassment,0,0,1,0,0,0,1,0,0,0,2,1,1,1,0,0,0,2,0,0,1,1,0,0,0,2,0,0,1,2
1583,Daman & Diu,2006,05. Sexual Harassment,0,0,0,0,0,0,0,0,0,0,1,1,0,0,0,0,0,1,0,0,0,0,0,0,0,0,0,0,0,0
1584,Delhi,2006,05. Sexual Harassment,113,8,114,0,19,0,122,0,69,47,468,486,144,114,132,0,0,600,144,0,163,41,33,90,185,528,27,177,664,705
1585,Goa,2006,05. Sexual Harassment,5,2,4,2,0,0,6,0,5,4,21,24,7,4,5,0,0,28,3,2,6,6,0,3,3,26,0,3,25,31
1586,Gujarat,2006,05. Sexual Harassment,47,9,118,3,15,2,127,0,17,8,802,749,138,118,62,0,0,867,55,3,143,139,19,1,5,1200,0,74,1138,1277
1587,Haryana,2006,05. Sexual Harassment,73,2,475,0,342,12,477,0,19,17,693,633,491,475,415,0,0,1108,97,0,584,581,384,8,11,1208,0,481,1108,1689
1588,Himachal Pradesh,2006,05. Sexual Harassment,18,4,26,1,5,2,30,0,1,2,83,81,31,26,23,0,0,107,19,3,34,35,5,1,0,157,0,24,149,184
1589,Jammu & Kashmir,2006,05. Sexual Harassment,175,2,350,4,82,6,352,0,57,68,923,834,347,350,257,0,0,1184,229,3,469,469,119,2,2,1358,0,348,1240,1709
1590,Jharkhand,2006,05. Sexual Harassment,21,3,28,3,5,2,31,0,22,11,0,4,44,28,26,3,0,29,11,6,33,66,5,46,13,198,0,16,154,220
1591,Karnataka,2006,05. Sexual Harassment,24,2,33,5,9,4,35,0,39,40,89,94,38,33,33,0,0,127,32,5,42,40,7,2,1,96,3,39,100,140
1592,Kerala,2006,05. Sexual Harassment,79,6,178,8,16,14,184,0,50,26,396,321,222,178,95,0,0,499,110,8,230,220,19,23,33,481,0,129,398,618
1593,Lakshadweep,2006,05. Sexual Harassment,0,0,0,0,0,0,0,0,0,0,0,0,0,0,0,0,0,0,0,0,0,0,0,0,0,0,0,0,0,0
1594,Madhya Pradesh,2006,05. Sexual Harassment,288,7,759,208,259,0,766,0,124,128,1666,1662,762,759,547,0,0,2421,372,226,970,973,467,3,0,2947,0,839,3039,4012
1595,Maharashtra,2006,05. Sexual Harassment,365,22,914,95,41,11,936,0,258,221,6967,6554,984,914,406,0,0,7468,473,125,1195,1188,43,145,149,8889,3,516,8342,9530
1596,Manipur,2006,05. Sexual Harassment,0,0,0,0,0,0,0,0,0,0,0,0,0,0,0,0,0,0,0,0,0,0,0,0,0,0,0,0,0,0
1597,Meghalaya,2006,05. Sexual Harassment,0,0,0,0,0,0,0,0,13,13,3,3,0,0,0,0,0,3,0,0,0,0,0,0,0,1,0,0,1,1
1598,Mizoram,2006,05. Sexual Harassment,0,1,2,0,3,0,3,0,0,3,0,1,0,2,3,0,0,3,0,0,0,3,3,3,0,1,0,3,1,4
1599,Nagaland,2006,05. Sexual Harassment,0,0,1,0,1,0,1,0,1,0,0,0,2,1,1,0,0,1,0,0,2,2,2,0,0,0,0,2,0,2
1600,Odisha,2006,05. Sexual Harassment,158,0,214,0,20,2,214,0,61,30,747,711,247,214,178,0,0,925,190,0,311,306,20,9,14,1152,0,210,1056,1362
1601,Puducherry,2006,05. Sexual Harassment,4,0,38,4,9,1,38,0,0,0,68,47,39,38,13,0,0,85,6,7,70,70,9,0,0,101,0,15,53,123
1602,Punjab,2006,05. Sexual Harassment,61,5,43,0,19,5,48,0,25,18,42,79,60,43,80,0,0,122,73,0,75,63,29,12,21,86,3,102,125,188
1603,Rajasthan,2006,05. Sexual Harassment,11,0,26,7,16,5,26,0,0,0,108,116,31,26,27,0,0,142,13,5,33,33,16,0,0,124,0,29,125,158
1604,Sikkim,2006,05. Sexual Harassment,0,0,0,0,0,0,0,0,0,0,0,0,0,0,0,0,0,0,0,0,0,0,0,0,0,0,0,0,0,0
1605,Tamil Nadu,2006,05. Sexual Harassment,280,20,745,0,203,28,765,2,73,16,967,705,852,745,483,0,0,1450,378,0,857,838,348,20,39,1041,0,726,929,1767
1606,Tripura,2006,05. Sexual Harassment,0,0,0,0,0,0,0,0,0,0,0,0,0,0,0,0,0,0,0,0,0,0,0,0,0,0,0,0,0,0
1607,Uttar Pradesh,2006,05. Sexual Harassment,662,12,2715,90,1716,6,2727,0,21,40,6223,5976,2714,2715,2378,0,0,8691,915,111,3852,3825,2312,65,37,9572,55,3227,9085,12910
1608,Uttarakhand,2006,05. Sexual Harassment,9,0,113,62,35,0,113,0,1,1,268,261,113,113,44,0,0,374,33,103,186,185,94,2,3,519,0,127,564,749
1609,West Bengal,2006,05. Sexual Harassment,61,7,51,3,16,0,58,0,46,41,50,79,63,51,77,0,0,130,80,3,76,55,20,40,52,76,9,100,124,179
1610,Andaman & Nicobar Islands,2007,05. Sexual Harassment,0,2,0,0,0,0,2,0,0,0,14,14,2,0,0,0,0,14,0,0,0,0,0,0,0,18,0,0,18,18
1611,Andhra Pradesh,2007,05. Sexual Harassment,1141,108,2785,545,917,332,2893,0,601,510,2347,2165,3316,2785,2058,0,0,4950,1455,697,3614,3654,964,868,738,3399,90,2419,2861,6515
1612,Arunachal Pradesh,2007,05. Sexual Harassment,0,0,2,0,0,0,2,0,0,1,8,6,1,2,0,0,0,8,0,0,5,6,0,1,0,13,0,0,7,13
1613,Assam,2007,05. Sexual Harassment,8,5,7,0,2,0,12,0,2,4,10,13,10,7,10,0,0,20,14,0,16,7,2,4,7,7,6,16,16,23
1614,Bihar,2007,05. Sexual Harassment,10,0,11,0,2,0,11,0,7,6,47,48,12,11,12,0,0,59,16,0,19,18,2,15,11,63,5,18,63,81
1615,Chandigarh,2007,05. Sexual Harassment,7,1,6,0,0,3,7,0,3,2,47,48,11,6,7,0,0,54,13,0,15,10,0,2,4,66,3,13,69,79
1616,Chhattisgarh,2007,05. Sexual Harassment,40,5,106,23,26,2,111,0,4,6,386,369,111,106,66,0,0,475,57,36,129,130,30,1,0,558,0,87,551,681
1617,Dadra & Nagar Haveli,2007,05. Sexual Harassment,0,0,0,0,0,0,0,0,0,0,2,2,0,0,0,0,0,2,0,0,0,0,0,0,0,2,0,0,2,2
1618,Daman & Diu,2007,05. Sexual Harassment,0,0,0,0,0,0,0,0,0,0,1,1,0,0,0,0,0,1,0,0,0,0,0,0,0,0,0,0,0,0
1619,Delhi,2007,05. Sexual Harassment,127,6,123,0,44,1,129,0,106,69,420,468,167,123,171,0,0,591,151,0,181,179,48,185,169,508,18,199,528,707
1620,Goa,2007,05. Sexual Harassment,5,2,6,0,1,0,8,0,4,5,21,21,7,6,6,0,0,27,7,0,6,8,1,3,1,26,0,8,26,34
1621,Gujarat,2007,05. Sexual Harassment,45,15,96,5,11,5,111,1,20,17,837,802,120,96,56,0,0,898,73,5,179,157,9,5,27,1270,0,82,1200,1357
1622,Haryana,2007,05. Sexual Harassment,95,7,394,0,229,8,401,0,19,19,763,693,409,394,324,0,0,1087,164,0,576,575,269,11,12,1350,0,433,1208,1783
1623,Himachal Pradesh,2007,05. Sexual Harassment,5,1,9,2,1,7,10,0,17,1,84,83,33,9,6,0,0,92,22,2,12,8,1,0,4,140,0,23,157,165
1624,Jammu & Kashmir,2007,05. Sexual Harassment,123,0,352,5,83,7,352,0,51,57,1064,923,353,352,206,0,0,1275,176,6,465,466,117,2,1,1525,0,293,1358,1824
1625,Jharkhand,2007,05. Sexual Harassment,8,2,14,0,0,3,16,0,18,22,6,0,15,14,8,0,0,14,142,0,23,24,0,13,12,80,0,142,198,222
1626,Karnataka,2007,05. Sexual Harassment,48,0,32,3,10,1,32,0,34,39,60,89,28,32,58,0,0,121,25,6,44,40,9,1,5,96,0,34,96,136
1627,Kerala,2007,05. Sexual Harassment,51,11,232,10,13,10,243,0,59,50,554,396,262,232,64,0,0,628,117,15,281,284,16,33,30,617,0,133,481,765
1628,Lakshadweep,2007,05. Sexual Harassment,0,0,0,0,0,0,0,0,0,0,0,0,0,0,0,0,0,0,0,0,0,0,0,0,0,0,0,0,0,0
1629,Madhya Pradesh,2007,05. Sexual Harassment,242,7,772,224,263,0,779,0,125,124,1709,1666,780,772,505,0,0,2438,392,356,1104,1104,455,0,0,2848,0,847,2947,4051
1630,Maharashtra,2007,05. Sexual Harassment,387,19,964,76,31,10,983,0,304,258,7437,6967,1039,964,418,0,0,7931,584,101,1291,1242,33,149,196,9413,2,617,8889,10131
1631,Manipur,2007,05. Sexual Harassment,0,0,0,0,0,0,0,0,0,0,0,0,0,0,0,0,0,0,0,0,0,0,0,0,0,0,0,0,0,0
1632,Meghalaya,2007,05. Sexual Harassment,0,0,0,0,0,0,0,0,14,13,3,3,1,0,0,0,0,3,0,0,0,0,0,0,0,1,0,0,1,1
1633,Mizoram,2007,05. Sexual Harassment,0,0,0,0,0,0,0,0,0,0,0,0,0,0,0,0,0,0,0,0,0,0,0,0,0,1,0,0,1,1
1634,Nagaland,2007,05. Sexual Harassment,0,0,1,0,0,0,1,0,1,1,1,0,1,1,0,0,0,1,0,0,1,1,0,0,0,1,0,0,0,1
1635,Odisha,2007,05. Sexual Harassment,65,4,218,0,14,4,222,0,76,61,886,747,241,218,79,0,0,965,141,0,317,315,24,14,16,1302,0,165,1152,1467
1636,Puducherry,2007,05. Sexual Harassment,4,0,31,8,13,1,31,0,0,0,74,68,32,31,17,0,0,99,9,13,52,52,23,0,0,108,0,32,101,153
1637,Punjab,2007,05. Sexual Harassment,13,12,48,0,16,3,60,0,10,25,61,42,48,48,29,0,0,90,18,0,59,62,21,21,12,109,6,39,86,148
1638,Rajasthan,2007,05. Sexual Harassment,7,0,19,2,14,7,19,0,2,0,101,108,28,19,21,3,0,124,15,6,34,34,15,0,0,122,0,30,124,158
1639,Sikkim,2007,05. Sexual Harassment,0,0,0,0,0,0,0,0,0,0,0,0,0,0,0,0,0,0,0,0,0,0,0,0,0,0,0,0,0,0
1640,Tamil Nadu,2007,05. Sexual Harassment,504,37,790,1,302,24,827,1,96,73,950,967,875,790,806,0,0,1757,420,0,931,921,333,39,48,1209,1,753,1041,1962
1641,Tripura,2007,05. Sexual Harassment,1,0,4,0,0,0,4,0,0,0,3,0,4,4,1,0,0,4,1,0,4,4,0,0,0,3,0,1,0,4
1642,Uttar Pradesh,2007,05. Sexual Harassment,741,21,2864,184,1649,5,2885,0,13,21,6513,6223,2882,2864,2390,0,0,9087,1202,259,4149,4124,2301,37,26,9934,36,3503,9572,13696
1643,Uttarakhand,2007,05. Sexual Harassment,7,0,58,15,50,1,58,0,5,1,254,268,63,58,57,0,0,326,6,79,128,123,62,3,6,495,2,68,519,642
1644,West Bengal,2007,05. Sexual Harassment,44,10,64,4,17,0,74,0,71,46,49,50,99,64,61,0,0,114,61,6,118,98,26,52,56,81,16,87,76,174
1645,Andaman & Nicobar Islands,2008,05. Sexual Harassment,0,0,2,0,0,0,2,0,1,0,16,14,3,2,0,0,0,16,0,0,4,2,0,0,2,20,0,0,18,20
1646,Andhra Pradesh,2008,05. Sexual Harassment,1165,212,2945,518,569,252,3157,0,743,601,3040,2347,3551,2945,1734,0,0,5292,1659,614,3240,3260,636,738,685,3750,33,2295,3399,6659
1647,Arunachal Pradesh,2008,05. Sexual Harassment,0,0,1,0,0,0,1,0,0,0,9,8,1,1,0,0,0,9,0,0,1,1,0,0,0,14,0,0,13,14
1648,Assam,2008,05. Sexual Harassment,2,0,2,0,0,0,2,0,2,2,10,10,2,2,2,0,0,12,1,0,2,2,0,7,7,8,0,1,7,9
1649,Bihar,2008,05. Sexual Harassment,4,2,12,0,3,0,14,0,14,7,52,47,21,12,7,0,0,59,4,0,30,28,3,11,13,84,0,7,63,91
1650,Chandigarh,2008,05. Sexual Harassment,1,0,5,0,6,0,5,0,0,3,45,47,2,5,7,0,0,52,1,0,3,7,6,4,0,66,0,7,66,73
1651,Chhattisgarh,2008,05. Sexual Harassment,37,3,123,22,27,0,126,0,3,4,423,386,125,123,64,0,0,509,48,26,165,162,40,0,3,606,0,88,558,720
1652,Dadra & Nagar Haveli,2008,05. Sexual Harassment,1,0,0,0,0,0,0,0,0,0,1,2,0,0,1,0,0,2,1,0,0,0,0,0,0,1,0,1,2,2
1653,Daman & Diu,2008,05. Sexual Harassment,0,0,0,0,0,0,0,0,1,0,1,1,1,0,0,0,0,1,0,0,0,0,0,0,0,0,0,0,0,0
1654,Delhi,2008,05. Sexual Harassment,29,11,131,0,57,0,142,0,94,106,465,420,130,131,86,0,0,551,99,0,141,163,68,169,143,504,4,167,508,671
1655,Goa,2008,05. Sexual Harassment,3,2,8,1,0,0,10,0,6,4,25,21,12,8,3,0,0,29,4,1,12,8,0,1,4,29,1,4,26,34
1656,Gujarat,2008,05. Sexual Harassment,63,8,120,4,5,3,128,0,11,20,885,837,122,120,68,0,0,957,129,4,161,181,12,27,7,1306,0,141,1270,1451
1657,Haryana,2008,05. Sexual Harassment,110,15,567,1,381,15,582,0,27,19,838,763,605,567,491,0,0,1330,145,1,731,716,451,12,27,1469,0,596,1350,2066
1658,Himachal Pradesh,2008,05. Sexual Harassment,11,8,36,2,5,1,44,0,13,17,102,84,41,36,16,0,0,120,14,3,55,45,8,4,14,160,0,22,140,185
1659,Jammu & Kashmir,2008,05. Sexual Harassment,109,1,284,5,69,4,285,0,58,51,1165,1064,296,284,178,0,0,1348,140,7,401,400,96,1,2,1682,0,236,1525,1925
1660,Jharkhand,2008,05. Sexual Harassment,6,5,16,0,1,1,21,0,19,18,15,6,23,16,7,0,0,22,82,0,63,55,1,12,20,52,0,83,80,135
1661,Karnataka,2008,05. Sexual Harassment,28,0,41,8,10,3,41,0,34,34,55,60,44,41,38,0,0,101,33,8,38,41,10,5,2,87,0,43,97,138
1662,Kerala,2008,05. Sexual Harassment,100,11,244,18,35,9,255,0,53,59,645,554,258,244,135,0,0,798,104,20,302,293,46,30,39,740,0,150,617,910
1663,Lakshadweep,2008,05. Sexual Harassment,0,0,0,0,0,0,0,0,0,0,0,0,0,0,0,0,0,0,0,0,0,0,0,0,0,0,0,0,0,0
1664,Madhya Pradesh,2008,05. Sexual Harassment,357,7,739,188,290,2,746,0,135,125,1613,1709,758,739,647,0,0,2448,539,238,958,956,452,0,2,2575,0,991,2848,3804
1665,Maharashtra,2008,05. Sexual Harassment,552,21,998,115,70,8,1019,0,368,304,7698,7437,1091,998,622,0,0,8435,673,131,1352,1351,76,196,197,9884,0,749,9413,10764
1666,Manipur,2008,05. Sexual Harassment,0,0,0,0,0,0,0,0,0,0,0,0,0,0,0,0,0,0,0,0,0,0,0,0,0,0,0,0,0,0
1667,Meghalaya,2008,05. Sexual Harassment,0,0,0,0,0,0,0,0,18,14,3,3,4,0,0,0,0,3,0,0,2,1,0,0,0,2,1,0,1,2
1668,Mizoram,2008,05. Sexual Harassment,0,0,0,0,0,0,0,0,0,0,0,0,0,0,0,0,0,0,0,0,0,0,0,0,0,1,0,0,1,1
1669,Nagaland,2008,05. Sexual Harassment,0,1,0,0,1,0,1,0,0,0,0,1,1,0,1,0,0,1,0,0,0,0,2,0,0,0,0,2,2,2
1670,Odisha,2008,05. Sexual Harassment,117,4,258,0,17,2,262,0,94,76,1010,886,282,258,134,0,0,1144,160,0,352,356,28,16,12,1470,0,188,1302,1658
1671,Puducherry,2008,05. Sexual Harassment,2,0,20,2,9,1,20,0,0,0,81,74,21,20,11,0,0,94,2,2,28,28,11,0,0,121,0,13,108,136
1672,Punjab,2008,05. Sexual Harassment,17,4,29,0,18,0,33,0,26,10,55,61,49,29,35,0,0,90,26,0,61,37,22,12,35,98,1,48,109,146
1673,Rajasthan,2008,05. Sexual Harassment,11,1,12,2,14,7,13,0,1,2,86,101,19,12,25,0,0,113,17,4,15,15,24,0,0,92,0,41,122,137
1674,Sikkim,2008,05. Sexual Harassment,0,0,0,0,0,0,0,0,0,0,0,0,0,0,0,0,0,0,0,0,0,0,0,0,0,0,0,0,0,0
1675,Tamil Nadu,2008,05. Sexual Harassment,465,27,856,0,317,37,883,0,150,96,1024,950,974,856,782,0,0,1806,560,0,1245,1101,379,48,191,1371,1,939,1209,2310
1676,Tripura,2008,05. Sexual Harassment,2,0,4,0,2,0,4,0,0,0,3,3,4,4,4,0,0,7,1,0,8,6,0,0,0,8,2,1,3,9
1677,Uttar Pradesh,2008,05. Sexual Harassment,807,22,3318,162,2130,25,3340,0,22,13,6732,6513,3374,3318,2937,0,0,9831,1255,256,4958,4876,3179,26,37,10120,71,4434,9934,14810
1678,Uttarakhand,2008,05. Sexual Harassment,1,1,289,1,72,3,290,0,18,5,469,254,306,289,73,0,0,543,2,6,459,443,250,6,22,680,0,252,495,938
1679,West Bengal,2008,05. Sexual Harassment,41,5,70,5,20,0,75,0,90,71,53,49,94,70,61,0,0,119,62,6,156,125,23,56,84,115,3,85,81,206
1680,Andaman & Nicobar Islands,2009,05. Sexual Harassment,0,0,4,0,0,0,4,0,4,1,20,16,7,4,0,0,0,20,0,0,8,4,0,2,6,24,0,0,20,24
1681,Andhra Pradesh,2009,05. Sexual Harassment,1577,193,3103,764,613,303,3296,0,664,743,3189,3040,3520,3103,2190,0,0,6143,1911,978,4178,3848,681,685,938,4028,77,2592,3750,7598
1682,Arunachal Pradesh,2009,05. Sexual Harassment,0,2,2,0,0,0,4,0,2,0,11,9,6,2,0,0,0,11,0,0,2,2,0,0,0,16,0,0,14,16
1683,Assam,2009,05. Sexual Harassment,6,2,5,0,3,0,7,0,5,2,6,10,10,5,9,0,0,15,5,0,15,7,3,7,9,7,6,8,8,15
1684,Bihar,2009,05. Sexual Harassment,16,6,14,0,0,0,20,0,6,14,50,52,12,14,16,0,0,66,31,0,16,20,0,13,9,73,0,31,84,104
1685,Chandigarh,2009,05. Sexual Harassment,8,0,1,0,4,1,1,0,0,0,34,45,2,1,12,0,0,46,8,0,6,1,6,0,0,53,5,14,66,67
1686,Chhattisgarh,2009,05. Sexual Harassment,66,7,140,22,26,0,147,0,8,3,449,423,152,140,92,0,0,563,81,23,235,233,56,3,5,679,0,137,606,839
1687,Dadra & Nagar Haveli,2009,05. Sexual Harassment,0,0,0,0,0,0,0,0,1,0,1,1,1,0,0,0,0,1,0,0,0,0,0,0,0,1,0,0,1,1
1688,Daman & Diu,2009,05. Sexual Harassment,0,0,2,0,0,0,2,0,0,1,3,1,1,2,0,0,0,3,0,0,1,1,0,0,0,1,0,0,0,1
1689,Delhi,2009,05. Sexual Harassment,34,2,92,0,53,0,94,2,116,94,470,465,118,92,87,0,0,557,60,0,132,151,68,143,121,527,3,128,504,655
1690,Goa,2009,05. Sexual Harassment,6,3,7,0,0,0,10,0,6,6,26,25,10,7,6,0,0,32,9,0,10,7,0,4,7,27,0,9,29,36
1691,Gujarat,2009,05. Sexual Harassment,54,10,107,0,14,3,117,0,5,11,924,885,114,107,68,0,0,992,82,0,188,190,22,7,5,1392,0,104,1306,1496
1692,Haryana,2009,05. Sexual Harassment,137,7,583,0,358,18,590,0,24,27,926,838,605,583,495,0,0,1421,191,0,717,717,396,27,27,1599,0,587,1469,2186
1693,Himachal Pradesh,2009,05. Sexual Harassment,8,3,37,3,1,3,40,0,7,13,127,102,37,37,9,0,0,139,8,7,40,51,1,14,0,195,3,9,160,211
1694,Jammu & Kashmir,2009,05. Sexual Harassment,146,0,365,19,99,10,365,0,54,58,1266,1165,371,365,245,0,0,1530,181,31,512,511,114,2,3,1867,0,295,1682,2193
1695,Jharkhand,2009,05. Sexual Harassment,10,2,36,7,11,3,38,0,61,19,23,15,83,36,21,0,0,51,15,0,38,35,14,20,23,58,0,29,52,87
1696,Karnataka,2009,05. Sexual Harassment,17,0,30,5,1,0,30,0,68,34,62,55,64,30,18,0,0,85,24,6,40,39,1,2,3,95,0,25,87,126
1697,Kerala,2009,05. Sexual Harassment,142,19,361,14,58,6,380,0,62,53,792,645,395,361,200,0,0,1006,158,14,456,445,68,39,50,945,0,226,740,1185
1698,Lakshadweep,2009,05. Sexual Harassment,0,0,0,0,0,0,0,0,0,0,0,0,0,0,0,0,0,0,0,0,0,0,0,0,0,0,0,0,0,0
1699,Madhya Pradesh,2009,05. Sexual Harassment,199,8,848,173,221,1,856,0,6,135,1868,1613,728,848,420,0,0,2461,273,207,1047,1042,285,2,7,2852,0,558,2575,3617
1700,Maharashtra,2009,05. Sexual Harassment,424,25,1021,103,22,6,1046,1,414,368,8170,7698,1099,1021,446,0,0,8719,602,104,1337,1275,23,197,256,10430,3,625,9884,11159
1701,Manipur,2009,05. Sexual Harassment,0,0,0,0,0,0,0,0,2,0,0,0,2,0,0,0,0,0,0,0,1,0,0,0,1,0,0,0,0,0
1702,Meghalaya,2009,05. Sexual Harassment,0,0,2,0,1,0,2,0,17,18,4,3,1,2,1,0,0,5,0,1,1,1,1,0,0,1,0,1,2,3
1703,Mizoram,2009,05. Sexual Harassment,0,0,1,0,0,0,1,0,0,0,1,0,1,1,0,0,0,1,0,0,1,1,0,0,0,2,0,0,1,2
1704,Nagaland,2009,05. Sexual Harassment,0,0,0,0,0,0,0,0,0,0,0,0,0,0,0,0,0,0,0,0,0,0,0,0,0,0,0,0,0,0
1705,Odisha,2009,05. Sexual Harassment,119,5,199,0,15,11,204,0,89,94,1075,1010,210,199,134,0,0,1209,158,0,297,290,19,12,19,1583,0,177,1470,1760
1706,Puducherry,2009,05. Sexual Harassment,6,0,13,2,6,1,13,1,1,0,80,81,16,13,12,0,0,94,10,2,21,21,9,0,0,121,0,19,121,142
1707,Punjab,2009,05. Sexual Harassment,19,6,34,0,13,2,40,0,17,26,57,55,33,34,32,0,0,89,26,0,50,40,18,35,44,94,1,44,98,138
1708,Rajasthan,2009,05. Sexual Harassment,6,0,21,4,9,4,21,0,0,1,88,86,24,21,15,0,0,107,10,8,24,24,16,0,0,82,0,26,92,116
1709,Sikkim,2009,05. Sexual Harassment,0,0,0,0,0,0,0,0,0,0,0,0,0,0,0,0,0,0,0,0,0,0,0,0,0,0,0,0,0,0
1710,Tamil Nadu,2009,05. Sexual Harassment,221,23,519,0,296,15,542,0,94,150,1026,1024,501,519,517,0,0,1543,305,0,568,651,371,191,106,1346,2,676,1371,2022
1711,Tripura,2009,05. Sexual Harassment,3,0,5,0,0,0,5,0,0,0,5,3,5,5,3,0,0,8,7,0,10,6,0,0,2,7,2,7,8,14
1712,Uttar Pradesh,2009,05. Sexual Harassment,637,27,2475,84,1838,27,2502,0,17,22,6648,6732,2524,2475,2475,0,0,9207,1041,128,3878,3807,2734,37,33,10024,75,3775,10120,13927
1713,Uttarakhand,2009,05. Sexual Harassment,3,1,259,1,98,1,260,0,6,18,626,469,249,259,101,0,0,728,13,2,419,431,254,22,10,842,0,267,680,1111
1714,West Bengal,2009,05. Sexual Harassment,48,15,91,7,24,1,106,0,91,90,65,53,108,91,72,0,0,144,70,7,120,102,26,84,84,114,18,96,115,217
1715,Andaman & Nicobar Islands,2010,05. Sexual Harassment,0,1,7,0,0,0,8,0,6,4,27,20,10,7,0,0,0,27,0,0,14,11,0,6,9,35,0,0,24,35
1716,Andhra Pradesh,2010,05. Sexual Harassment,1360,1116,3332,772,731,258,4448,5,515,664,3658,3189,4562,3332,2091,0,0,6521,1793,972,3820,3965,861,938,715,4367,78,2654,4028,7993
1717,Arunachal Pradesh,2010,05. Sexual Harassment,0,2,0,0,0,0,2,0,1,2,11,11,1,0,0,0,0,11,0,0,1,0,0,0,1,16,0,0,16,16
1718,Assam,2010,05. Sexual Harassment,4,5,9,0,3,2,14,0,9,5,8,6,20,9,7,0,0,15,7,0,35,13,6,9,20,7,11,13,7,20
1719,Bihar,2010,05. Sexual Harassment,3,2,9,1,0,1,11,0,10,6,55,50,16,9,3,0,0,59,9,3,22,20,0,9,10,81,1,9,73,93
1720,Chandigarh,2010,05. Sexual Harassment,9,0,0,0,8,0,0,0,4,0,17,34,4,0,17,0,0,34,11,0,2,0,12,0,2,30,0,23,53,53
1721,Chhattisgarh,2010,05. Sexual Harassment,53,4,172,18,31,1,176,0,13,8,519,449,182,172,84,0,0,621,82,31,261,258,65,5,6,759,2,147,679,937
1722,Dadra & Nagar Haveli,2010,05. Sexual Harassment,0,0,1,0,0,1,1,0,1,1,2,1,2,1,0,0,0,2,0,0,2,2,0,0,0,3,0,0,1,3
1723,Daman & Diu,2010,05. Sexual Harassment,1,0,0,0,0,0,0,0,0,0,2,3,0,0,1,0,0,3,1,0,0,0,0,0,0,2,0,1,3,3
1724,Delhi,2010,05. Sexual Harassment,40,4,100,0,47,1,104,0,91,116,483,470,80,100,87,0,0,570,52,0,89,100,74,121,110,501,0,126,527,627
1725,Goa,2010,05. Sexual Harassment,4,2,13,0,2,0,15,0,7,6,33,26,16,13,6,0,0,39,4,0,22,21,2,7,6,42,2,6,27,48
1726,Gujarat,2010,05. Sexual Harassment,65,7,98,4,9,1,105,0,9,5,944,924,110,98,74,0,0,1022,112,5,131,134,13,5,2,1396,0,125,1392,1526
1727,Haryana,2010,05. Sexual Harassment,107,11,526,0,334,21,537,0,46,24,1011,926,580,526,441,0,0,1452,156,0,635,628,408,27,34,1663,0,564,1599,2227
1728,Himachal Pradesh,2010,05. Sexual Harassment,11,9,51,5,1,5,60,0,20,7,161,127,78,51,12,0,0,178,14,9,73,65,1,0,8,236,0,15,195,260
1729,Jammu & Kashmir,2010,05. Sexual Harassment,103,7,234,4,100,12,241,0,63,54,1293,1266,262,234,203,0,0,1500,134,8,295,295,139,3,3,1881,0,273,1867,2162
1730,Jharkhand,2010,05. Sexual Harassment,8,6,11,2,3,1,17,0,59,61,21,23,16,11,11,0,0,34,17,5,20,37,3,23,6,70,0,20,58,95
1731,Karnataka,2010,05. Sexual Harassment,22,1,16,7,0,4,17,0,130,68,49,62,83,16,22,0,0,78,27,15,22,21,0,3,4,74,0,27,95,116
1732,Kerala,2010,05. Sexual Harassment,162,10,515,10,70,12,525,0,62,62,1065,792,537,515,232,0,0,1307,190,12,604,617,78,50,37,1282,0,268,945,1562
1733,Lakshadweep,2010,05. Sexual Harassment,0,0,0,0,0,0,0,0,0,0,0,0,0,0,0,0,0,0,0,0,0,0,0,0,0,0,0,0,0,0
1734,Madhya Pradesh,2010,05. Sexual Harassment,297,6,899,237,309,2,905,0,17,6,1924,1868,918,899,606,0,0,2767,454,254,1182,1183,340,7,5,2987,1,794,2852,4035
1735,Maharashtra,2010,05. Sexual Harassment,630,26,1063,95,34,12,1089,0,493,414,8474,8170,1180,1063,664,0,0,9233,789,126,1515,1441,42,256,330,10914,0,831,10430,11871
1736,Manipur,2010,05. Sexual Harassment,0,0,0,0,0,0,0,0,2,2,0,0,0,0,0,0,0,0,0,0,0,0,0,1,1,0,0,0,0,0
1737,Meghalaya,2010,05. Sexual Harassment,0,0,0,0,0,0,0,0,17,17,4,4,0,0,0,0,0,4,0,0,0,0,0,0,0,1,0,0,1,1
1738,Mizoram,2010,05. Sexual Harassment,0,0,0,0,1,0,0,0,0,0,0,1,0,0,1,0,0,1,0,0,0,0,2,0,0,0,0,2,2,2
1739,Nagaland,2010,05. Sexual Harassment,0,0,2,0,0,0,2,0,1,0,2,0,3,2,0,0,0,2,0,0,3,3,0,0,0,3,0,0,0,3
1740,Odisha,2010,05. Sexual Harassment,129,3,231,0,11,11,234,0,76,89,1166,1075,232,231,140,0,0,1306,233,0,354,346,16,19,27,1680,0,249,1583,1929
1741,Puducherry,2010,05. Sexual Harassment,8,1,20,1,2,2,21,0,0,1,89,80,22,20,10,0,0,100,17,1,28,26,6,0,0,123,2,23,121,147
1742,Punjab,2010,05. Sexual Harassment,12,7,27,0,13,3,34,0,17,16,52,50,38,27,25,0,0,77,16,0,42,36,17,45,49,84,2,33,81,117
1743,Rajasthan,2010,05. Sexual Harassment,2,1,17,2,9,3,18,0,2,0,92,88,23,17,11,0,0,105,4,2,22,22,11,0,0,87,0,15,82,104
1744,Sikkim,2010,05. Sexual Harassment,0,0,0,0,0,0,0,0,0,0,0,0,0,0,0,0,0,0,0,0,0,0,0,0,0,0,0,0,0,0
1745,Tamil Nadu,2010,05. Sexual Harassment,307,16,624,0,417,6,640,0,86,94,926,1026,638,624,724,0,0,1650,419,0,739,752,353,106,88,1326,5,772,1346,2098
1746,Tripura,2010,05. Sexual Harassment,2,3,4,0,0,0,7,0,2,0,7,5,9,4,2,0,0,9,7,0,9,7,0,2,4,7,0,7,7,14
1747,Uttar Pradesh,2010,05. Sexual Harassment,604,7,21,0,1951,0,28,0,0,17,4114,6648,11,21,2555,0,0,6669,1095,0,15,36,3157,33,0,5808,12,4252,10024,10060
1748,Uttarakhand,2010,05. Sexual Harassment,29,1,169,0,244,0,170,0,1,6,522,626,165,169,273,0,0,795,79,0,282,291,228,10,1,826,0,307,842,1133
1749,West Bengal,2010,05. Sexual Harassment,55,11,127,11,37,1,138,0,115,91,89,65,163,127,92,0,0,192,68,11,165,140,44,84,93,131,16,112,114,254
1750,Andaman & Nicobar Islands,2001,06. Cruelty by Husband and Relatives,6,3,5,0,0,0,8,0,4,3,10,11,9,5,6,0,0,16,6,0,7,9,0,2,0,17,0,6,14,23
1751,Andhra Pradesh,2001,06. Cruelty by Husband and Relatives,2956,114,4428,688,762,1168,4542,6,1862,1787,7017,6996,5791,4428,3718,1,0,11423,4933,1234,9725,8554,1027,2657,3354,13003,474,5960,11643,20197
1752,Arunachal Pradesh,2001,06. Cruelty by Husband and Relatives,0,2,8,0,1,0,10,0,2,1,22,15,11,8,1,0,0,23,0,0,9,10,1,2,1,19,0,1,10,20
1753,Assam,2001,06. Cruelty by Husband and Relatives,255,325,585,71,42,92,910,0,1011,765,1857,1640,1248,585,297,0,0,2225,409,91,1515,840,59,741,962,3011,454,468,2730,3570
1754,Bihar,2001,06. Cruelty by Husband and Relatives,397,165,1217,77,165,97,1382,0,816,737,2751,2173,1558,1217,562,0,0,3390,1512,174,3838,3176,330,1545,1767,7276,440,1842,6116,9292
1755,Chandigarh,2001,06. Cruelty by Husband and Relatives,10,17,19,0,2,3,36,0,23,26,78,71,36,19,12,0,0,90,34,0,33,66,8,62,10,291,19,42,267,333
1756,Chhattisgarh,2001,06. Cruelty by Husband and Relatives,177,19,847,19,87,1,866,0,27,54,2468,1904,840,847,264,0,0,2751,314,51,1439,1443,205,13,9,5161,0,519,4288,5731
1757,Dadra & Nagar Haveli,2001,06. Cruelty by Husband and Relatives,0,0,2,0,0,0,2,0,2,0,18,16,4,2,0,0,0,18,0,0,4,3,0,0,1,39,0,0,36,39
1758,Daman & Diu,2001,06. Cruelty by Husband and Relatives,1,0,4,0,0,0,4,0,1,1,6,3,4,4,1,0,0,7,7,0,13,18,0,6,1,18,0,7,7,25
1759,Delhi,2001,06. Cruelty by Husband and Relatives,45,45,122,0,67,4,167,0,16,49,346,336,138,122,112,0,0,458,136,0,1200,1103,107,298,363,4797,32,243,3937,5040
1760,Goa,2001,06. Cruelty by Husband and Relatives,20,1,11,1,1,0,12,0,4,5,32,43,11,11,21,0,0,54,59,3,36,37,1,8,7,96,0,60,122,159
1761,Gujarat,2001,06. Cruelty by Husband and Relatives,1370,63,3497,266,46,116,3560,13,167,189,16239,14424,3667,3497,1416,0,0,17921,4498,658,10192,10301,127,503,383,46136,11,4625,41118,51419
1762,Haryana,2001,06. Cruelty by Husband and Relatives,633,274,963,0,57,280,1237,0,193,197,2943,2670,1513,963,690,0,0,3633,2161,0,3134,3154,181,248,222,9789,6,2342,8977,12131
1763,Himachal Pradesh,2001,06. Cruelty by Husband and Relatives,126,5,291,53,6,22,296,0,47,48,978,872,317,291,132,0,0,1163,248,138,648,642,10,58,54,2096,10,258,1850,2492
1764,Jammu & Kashmir,2001,06. Cruelty by Husband and Relatives,10,3,44,12,0,3,47,1,10,11,79,57,50,44,10,0,0,101,69,34,110,111,0,2,0,146,1,69,138,249
1765,Jharkhand,2001,06. Cruelty by Husband and Relatives,239,36,450,17,60,11,486,0,199,212,743,609,484,450,299,0,0,1059,475,67,943,822,115,513,493,1409,141,590,1244,2066
1766,Karnataka,2001,06. Cruelty by Husband and Relatives,951,70,1605,107,52,179,1675,22,376,497,3828,3339,1755,1605,1003,6,0,4938,2192,197,3413,3238,110,499,523,7287,151,2302,6548,9786
1767,Kerala,2001,06. Cruelty by Husband and Relatives,916,26,2061,153,91,263,2087,37,774,600,6628,5727,2561,2061,1007,0,0,7788,2211,235,4288,4234,147,808,830,12766,32,2358,11125,15359
1768,Lakshadweep,2001,06. Cruelty by Husband and Relatives,0,0,0,0,0,0,0,0,0,0,0,0,0,0,0,0,0,0,0,0,0,0,0,0,0,0,0,0,0,0
1769,Madhya Pradesh,2001,06. Cruelty by Husband and Relatives,701,10,2533,444,590,6,2543,0,136,144,8860,8063,2562,2533,1291,1,21,10595,2092,1495,7155,7173,1322,110,92,23331,0,3414,21067,28240
1770,Maharashtra,2001,06. Cruelty by Husband and Relatives,4354,102,6057,1063,228,17,6159,0,701,787,40272,39860,6090,6057,4582,0,0,45917,15151,2629,20940,21246,547,2969,2656,120048,7,15698,117129,138375
1771,Manipur,2001,06. Cruelty by Husband and Relatives,0,2,0,0,0,0,2,0,10,7,0,0,5,0,0,0,0,0,0,0,4,0,0,0,4,0,0,0,0,0
1772,Meghalaya,2001,06. Cruelty by Husband and Relatives,0,1,3,0,0,0,4,0,0,0,6,3,4,3,0,0,0,6,0,0,3,3,0,0,0,6,0,0,3,6
1773,Mizoram,2001,06. Cruelty by Husband and Relatives,0,1,0,0,0,0,1,0,15,0,0,0,16,0,0,0,0,0,0,0,0,0,0,0,0,0,0,0,0,0
1774,Nagaland,2001,06. Cruelty by Husband and Relatives,0,0,0,0,0,0,0,0,1,1,1,1,0,0,0,0,0,1,0,0,0,0,0,0,0,0,0,0,0,0
1775,Odisha,2001,06. Cruelty by Husband and Relatives,614,59,1186,0,108,36,1245,1,564,580,2988,2524,1266,1186,722,0,0,3710,1402,0,1972,1904,281,104,159,5626,13,1683,5405,7309
1776,Puducherry,2001,06. Cruelty by Husband and Relatives,4,0,4,0,0,0,4,0,1,2,5,5,3,4,4,0,0,9,6,0,3,5,0,2,0,6,0,6,7,12
1777,Punjab,2001,06. Cruelty by Husband and Relatives,165,318,563,30,62,109,881,7,727,596,1103,797,1128,563,227,0,0,1360,830,88,2746,1786,353,1474,2142,3305,292,1183,2790,4576
1778,Rajasthan,2001,06. Cruelty by Husband and Relatives,1415,5,3451,416,751,2150,3456,0,248,322,11415,10546,5532,3451,2166,0,0,13997,3155,887,7082,7068,1805,36,49,25552,1,4960,24331,31399
1779,Sikkim,2001,06. Cruelty by Husband and Relatives,1,0,0,0,0,0,0,0,0,0,1,2,0,0,1,0,0,2,0,0,0,0,0,1,1,0,0,0,0,0
1780,Tamil Nadu,2001,06. Cruelty by Husband and Relatives,253,16,685,15,174,97,701,8,172,167,1314,1082,815,685,427,11,4,1756,575,35,1545,1347,260,267,407,2718,58,835,2241,3588
1781,Tripura,2001,06. Cruelty by Husband and Relatives,46,15,138,2,13,0,153,0,130,56,251,174,227,138,59,0,0,312,98,0,252,197,30,73,78,231,50,128,162,359
1782,Uttar Pradesh,2001,06. Cruelty by Husband and Relatives,1352,1577,4843,714,1515,758,6420,0,1144,957,11323,10061,7365,4843,2867,0,0,14904,4313,2265,19827,17521,5300,1815,2479,41101,1642,9613,35458,52979
1783,Uttarakhand,2001,06. Cruelty by Husband and Relatives,48,66,208,6,121,29,274,0,32,34,332,299,301,208,169,0,0,507,137,49,746,639,278,83,145,1023,45,415,848,1487
1784,West Bengal,2001,06. Cruelty by Husband and Relatives,912,259,3176,5,123,118,3435,7,3204,2905,22006,19870,3859,3176,1035,0,0,23046,3675,0,6645,5827,312,3976,3398,30544,1396,3987,28704,34531
1785,Andaman & Nicobar Islands,2002,06. Cruelty by Husband and Relatives,3,5,3,0,0,0,8,0,0,4,10,10,4,3,3,0,0,13,3,0,3,3,0,0,0,17,0,3,17,20
1786,Andhra Pradesh,2002,06. Cruelty by Husband and Relatives,2511,98,5132,885,595,1657,5230,18,1975,1862,8157,7017,7018,5132,3106,1,0,12148,4855,1238,12134,9958,1023,3354,4862,15845,668,5878,13003,22961
1787,Arunachal Pradesh,2002,06. Cruelty by Husband and Relatives,1,0,12,0,0,0,12,0,3,2,33,22,13,12,1,0,0,34,0,1,5,4,0,1,2,22,0,0,19,23
1788,Assam,2002,06. Cruelty by Husband and Relatives,552,292,1076,59,53,199,1368,0,1138,1011,2269,1857,1694,1076,605,0,0,2933,861,105,2108,1422,58,962,1186,3409,462,919,3011,4433
1789,Bihar,2002,06. Cruelty by Husband and Relatives,493,219,1204,27,149,77,1423,0,893,816,3286,2751,1577,1204,642,0,0,3955,1202,74,4278,3622,298,1767,1600,9296,823,1500,7248,10870
1790,Chandigarh,2002,06. Cruelty by Husband and Relatives,7,18,30,0,1,5,48,0,26,23,100,78,56,30,8,0,0,108,17,0,51,22,3,10,18,293,21,20,291,313
1791,Chhattisgarh,2002,06. Cruelty by Husband and Relatives,170,5,674,125,82,1,679,0,0,27,2770,2473,653,674,252,0,0,3147,942,194,1519,1507,330,7,19,4250,0,1272,4209,5716
1792,Dadra & Nagar Haveli,2002,06. Cruelty by Husband and Relatives,4,0,5,0,0,0,5,0,0,2,19,18,3,5,4,0,0,23,14,0,8,9,0,1,0,34,0,14,39,48
1793,Daman & Diu,2002,06. Cruelty by Husband and Relatives,1,1,2,0,0,0,3,0,1,1,7,6,3,2,1,0,0,8,5,0,4,2,0,1,3,15,0,5,18,20
1794,Delhi,2002,06. Cruelty by Husband and Relatives,49,22,79,0,9,3,101,2,45,16,367,346,135,79,58,0,0,425,375,0,844,781,95,363,413,5108,13,470,4797,5578
1795,Goa,2002,06. Cruelty by Husband and Relatives,4,0,6,0,3,0,6,0,6,4,30,32,8,6,7,1,0,37,11,5,11,13,6,7,3,87,2,17,96,109
1796,Gujarat,2002,06. Cruelty by Husband and Relatives,1434,57,3121,327,78,93,3178,12,205,167,17521,16239,3321,3121,1512,0,0,19360,4355,934,9413,9362,180,383,425,50029,9,4535,46136,55498
1797,Haryana,2002,06. Cruelty by Husband and Relatives,675,289,971,37,80,335,1260,0,163,193,3122,2943,1565,971,755,0,0,3914,2540,20,3159,3246,232,222,135,10243,0,2772,9789,13035
1798,Himachal Pradesh,2002,06. Cruelty by Husband and Relatives,146,0,219,31,11,22,219,0,40,47,1009,978,234,219,157,0,0,1197,317,82,485,472,20,54,60,2149,7,337,2096,2568
1799,Jammu & Kashmir,2002,06. Cruelty by Husband and Relatives,27,0,39,12,0,6,39,0,19,10,79,79,54,39,27,0,0,118,58,23,113,101,0,0,10,166,2,58,146,247
1800,Jharkhand,2002,06. Cruelty by Husband and Relatives,284,25,476,26,67,6,501,0,439,358,1877,1778,588,476,351,0,0,2254,858,67,1125,1066,108,507,484,1104,82,966,1071,2137
1801,Karnataka,2002,06. Cruelty by Husband and Relatives,1060,138,1466,99,55,239,1604,24,335,376,4080,3828,1826,1466,1115,0,0,5294,2526,224,3219,3018,102,523,578,7453,146,2628,7287,10305
1802,Kerala,2002,06. Cruelty by Husband and Relatives,1048,44,2355,131,94,401,2399,53,757,774,7710,6628,2836,2355,1142,0,0,8983,2467,195,5028,5037,152,830,782,14989,39,2619,12766,17803
1803,Lakshadweep,2002,06. Cruelty by Husband and Relatives,0,0,0,0,0,0,0,0,0,0,0,0,0,0,0,0,0,0,0,0,0,0,0,0,0,0,0,0,0,0
1804,Madhya Pradesh,2002,06. Cruelty by Husband and Relatives,805,36,3075,557,396,9,3111,0,133,136,10177,8860,3117,3075,1201,0,0,11935,2883,1642,8497,8505,1316,92,84,25995,0,4199,23331,31836
1805,Maharashtra,2002,06. Cruelty by Husband and Relatives,4936,15,5156,788,221,26,5171,0,857,701,39483,40272,5353,5156,5157,0,0,45428,15882,1872,20255,21318,541,2656,1584,123071,9,16423,120048,141366
1806,Manipur,2002,06. Cruelty by Husband and Relatives,0,5,0,0,0,0,5,0,15,10,0,0,10,0,0,0,0,0,0,0,11,0,0,4,7,0,8,0,0,0
1807,Meghalaya,2002,06. Cruelty by Husband and Relatives,0,0,0,0,0,0,0,0,0,0,6,6,0,0,0,0,0,6,0,0,0,0,0,0,0,6,0,0,6,6
1808,Mizoram,2002,06. Cruelty by Husband and Relatives,0,0,2,0,1,0,2,0,1,0,1,0,3,2,1,0,0,2,0,0,3,3,1,0,0,2,0,1,0,3
1809,Nagaland,2002,06. Cruelty by Husband and Relatives,0,0,0,0,0,0,0,0,1,1,1,1,0,0,0,0,0,1,0,0,0,0,0,0,0,0,0,0,0,0
1810,Odisha,2002,06. Cruelty by Husband and Relatives,531,27,1109,3,91,23,1136,1,571,564,3471,2988,1167,1109,622,1,0,4096,1140,3,2076,2065,217,159,170,6331,0,1357,5626,7691
1811,Puducherry,2002,06. Cruelty by Husband and Relatives,1,0,6,0,0,0,6,2,2,1,10,5,9,6,1,0,0,11,1,0,12,12,0,0,0,17,0,1,6,18
1812,Punjab,2002,06. Cruelty by Husband and Relatives,181,199,637,20,116,120,836,16,699,727,1423,1103,944,637,297,0,0,1740,588,44,2514,2469,220,2142,1942,4922,245,808,3305,5774
1813,Rajasthan,2002,06. Cruelty by Husband and Relatives,1748,4,3461,434,1126,2130,3465,0,344,248,11568,11415,5691,3461,2874,0,0,14876,4144,1066,7312,7327,2294,49,34,25375,0,6438,25552,32879
1814,Sikkim,2002,06. Cruelty by Husband and Relatives,0,1,2,0,0,0,3,0,0,0,3,1,3,2,0,0,0,3,0,0,3,0,0,1,3,0,1,0,0,0
1815,Tamil Nadu,2002,06. Cruelty by Husband and Relatives,277,37,842,41,130,103,879,17,225,172,1708,1314,1052,842,407,0,0,2156,837,20,1797,1788,342,407,379,3307,37,1179,2718,4506
1816,Tripura,2002,06. Cruelty by Husband and Relatives,73,9,210,0,9,0,219,0,147,130,379,251,236,210,82,0,0,461,151,17,249,195,9,78,87,249,45,160,231,426
1817,Uttar Pradesh,2002,06. Cruelty by Husband and Relatives,1603,1178,4557,858,1689,721,5735,0,367,1144,11730,11323,5679,4557,3292,0,0,15880,5874,2407,17126,16953,6296,2479,1266,43477,1386,12170,41101,58054
1818,Uttarakhand,2002,06. Cruelty by Husband and Relatives,27,78,204,2,54,29,282,0,37,32,453,332,316,204,81,0,0,536,77,3,802,485,79,145,105,1349,357,156,1023,1508
1819,West Bengal,2002,06. Cruelty by Husband and Relatives,2402,241,3780,0,477,15,4021,7,3230,3204,22907,22006,4069,3780,2879,0,0,25786,4314,0,8792,6313,722,3398,4879,31821,998,5036,30544,36857
1820,Andaman & Nicobar Islands,2003,06. Cruelty by Husband and Relatives,2,1,3,0,0,0,4,0,3,0,11,10,7,3,2,0,0,13,2,0,15,6,0,0,5,21,4,2,17,23
1821,Andhra Pradesh,2003,06. Cruelty by Husband and Relatives,3056,100,5880,1173,672,2217,5980,42,1903,1975,9135,8157,8167,5880,3728,1,0,14036,8370,2326,15784,15878,1726,4862,4227,19301,541,10096,15845,31723
1822,Arunachal Pradesh,2003,06. Cruelty by Husband and Relatives,0,1,11,0,1,0,12,0,5,3,43,33,14,11,1,0,0,44,0,0,9,6,0,2,2,28,3,0,22,28
1823,Assam,2003,06. Cruelty by Husband and Relatives,702,333,1148,165,52,259,1481,0,1206,1138,2498,2269,1808,1148,754,0,0,3417,1213,213,2473,1672,129,1186,1380,3526,607,1342,3409,5081
1824,Bihar,2003,06. Cruelty by Husband and Relatives,643,208,1332,109,144,83,1540,0,1150,893,3720,3286,1880,1332,787,2,0,4616,1649,98,3940,3357,297,1600,1378,10609,805,1946,9296,12653
1825,Chandigarh,2003,06. Cruelty by Husband and Relatives,6,15,42,0,0,14,57,0,48,26,136,100,93,42,6,0,0,142,16,0,112,73,0,18,40,350,17,16,293,366
1826,Chhattisgarh,2003,06. Cruelty by Husband and Relatives,172,7,569,209,99,3,576,0,37,15,2838,2749,601,569,271,0,0,3318,337,715,1528,1535,179,19,12,5944,0,516,5640,7175
1827,Dadra & Nagar Haveli,2003,06. Cruelty by Husband and Relatives,0,0,1,0,0,0,1,0,1,0,20,19,2,1,0,0,0,20,0,0,2,1,0,0,1,35,0,0,34,35
1828,Daman & Diu,2003,06. Cruelty by Husband and Relatives,2,0,1,0,0,0,1,0,0,1,6,7,0,1,2,0,0,8,2,0,0,3,0,3,0,16,0,2,15,18
1829,Delhi,2003,06. Cruelty by Husband and Relatives,81,21,314,0,10,9,335,1,911,45,590,367,1211,314,91,0,0,681,649,0,2594,2500,97,413,489,6862,18,746,5108,7608
1830,Goa,2003,06. Cruelty by Husband and Relatives,3,2,14,2,1,0,16,0,14,6,38,30,24,14,4,0,0,44,8,5,55,28,1,3,28,101,2,9,87,115
1831,Gujarat,2003,06. Cruelty by Husband and Relatives,1387,53,3522,218,56,75,3575,13,226,205,19382,17521,3684,3522,1443,0,0,21043,4187,642,10818,10723,277,425,503,55646,17,4464,50029,60752
1832,Haryana,2003,06. Cruelty by Husband and Relatives,656,235,985,21,66,415,1220,0,146,163,3364,3122,1618,985,722,0,0,4107,2266,10,3044,3024,272,135,155,10719,0,2538,10243,13267
1833,Himachal Pradesh,2003,06. Cruelty by Husband and Relatives,139,0,209,47,10,16,209,0,36,40,1022,1009,221,209,149,0,0,1218,288,153,460,459,22,60,55,2145,6,310,2149,2608
1834,Jammu & Kashmir,2003,06. Cruelty by Husband and Relatives,47,1,58,5,7,10,59,0,21,19,78,79,71,58,54,0,0,137,46,34,149,157,23,10,2,220,0,69,166,323
1835,Jharkhand,2003,06. Cruelty by Husband and Relatives,264,45,461,47,47,5,506,0,487,439,1980,1877,559,461,311,0,0,2338,623,75,1025,1076,147,484,349,1335,84,770,1104,2180
1836,Karnataka,2003,06. Cruelty by Husband and Relatives,1036,61,1521,138,47,164,1582,19,274,335,4380,4080,1704,1521,1083,0,0,5601,2775,136,3419,3102,105,578,470,7539,425,2880,7453,10555
1837,Kerala,2003,06. Cruelty by Husband and Relatives,1289,65,2311,156,96,363,2376,56,892,757,8480,7710,2930,2311,1385,0,0,10021,2720,319,5004,4715,209,782,888,16456,183,2929,14989,19704
1838,Lakshadweep,2003,06. Cruelty by Husband and Relatives,0,0,0,0,0,0,0,0,1,0,0,0,1,0,0,0,0,0,0,0,0,0,0,0,0,0,0,0,0,0
1839,Madhya Pradesh,2003,06. Cruelty by Husband and Relatives,1192,20,2934,580,645,5,2954,0,109,130,10535,10018,2938,2934,1837,0,0,12952,2970,1615,8265,8246,1893,78,97,29155,0,4863,27387,35633
1840,Maharashtra,2003,06. Cruelty by Husband and Relatives,4024,31,5368,568,176,22,5399,0,888,857,40083,39483,5452,5368,4200,0,0,44851,14888,1382,19932,19753,454,1584,1756,126100,7,15342,123071,142824
1841,Manipur,2003,06. Cruelty by Husband and Relatives,0,6,1,0,0,0,7,0,12,15,1,0,4,1,0,0,0,1,0,0,10,0,0,7,15,0,2,0,0,0
1842,Meghalaya,2003,06. Cruelty by Husband and Relatives,0,0,1,0,0,0,1,0,3,0,7,6,4,1,0,0,0,7,0,0,1,1,0,0,0,7,0,0,6,7
1843,Mizoram,2003,06. Cruelty by Husband and Relatives,0,0,4,0,1,0,4,0,0,1,4,1,3,4,1,0,0,5,0,0,2,2,3,0,0,1,0,3,2,4
1844,Nagaland,2003,06. Cruelty by Husband and Relatives,0,0,0,0,0,0,0,0,1,1,1,1,0,0,0,0,0,1,0,0,0,0,0,0,0,0,0,0,0,0
1845,Odisha,2003,06. Cruelty by Husband and Relatives,469,56,1308,0,94,62,1364,3,431,571,4216,3471,1289,1308,563,0,0,4779,1434,0,2215,2237,235,170,148,6899,0,1669,6331,8568
1846,Puducherry,2003,06. Cruelty by Husband and Relatives,3,0,3,0,0,0,3,0,3,2,10,10,4,3,3,0,0,13,6,0,4,3,0,0,1,14,0,6,17,20
1847,Punjab,2003,06. Cruelty by Husband and Relatives,248,127,727,13,119,152,854,5,675,699,1770,1423,987,727,367,0,0,2150,742,121,2177,1848,419,1942,1986,5488,285,1161,4922,6770
1848,Rajasthan,2003,06. Cruelty by Husband and Relatives,1282,8,3443,539,778,2220,3451,0,406,344,12412,11568,5733,3443,2060,0,0,15011,2818,1307,7058,7036,1495,34,54,26791,2,4313,25375,32411
1849,Sikkim,2003,06. Cruelty by Husband and Relatives,0,0,1,1,1,0,1,0,0,0,2,3,1,1,1,0,0,4,0,0,1,3,0,3,1,3,0,0,0,3
1850,Tamil Nadu,2003,06. Cruelty by Husband and Relatives,472,58,1158,34,93,183,1216,37,328,224,2369,1810,1555,1158,565,0,15,2968,981,139,2558,2246,349,381,657,4057,36,1330,3280,5526
1851,Tripura,2003,06. Cruelty by Husband and Relatives,87,45,189,0,44,0,234,0,160,147,437,379,247,189,131,0,0,568,176,0,477,322,25,87,140,370,102,201,249,571
1852,Uttar Pradesh,2003,06. Cruelty by Husband and Relatives,1031,402,1920,545,1064,300,2322,1,370,367,11007,11730,2626,1920,2095,3,0,13647,3337,1910,7089,7370,3774,1266,848,41826,137,7111,43477,50847
1853,Uttarakhand,2003,06. Cruelty by Husband and Relatives,33,56,202,7,85,36,258,0,60,37,530,453,317,202,118,0,0,655,93,22,854,664,170,105,161,1728,134,263,1349,2013
1854,West Bengal,2003,06. Cruelty by Husband and Relatives,2047,137,4991,5,101,27,5128,6,3017,3230,25745,22907,4948,4991,2148,0,0,27898,5013,7,9549,8934,257,4879,4573,35478,921,5270,31821,40755
1855,Andaman & Nicobar Islands,2004,06. Cruelty by Husband and Relatives,3,2,3,0,0,0,5,0,3,3,11,11,5,3,3,0,0,14,7,0,15,10,0,5,10,24,0,7,21,31
1856,Andhra Pradesh,2004,06. Cruelty by Husband and Relatives,2846,220,5851,1299,727,1558,6071,30,2632,1903,10114,9135,8388,5851,3573,0,0,14986,6544,3241,15583,14539,1651,4227,4671,22404,600,8195,19301,33840
1857,Arunachal Pradesh,2004,06. Cruelty by Husband and Relatives,0,1,4,0,0,0,5,0,4,5,47,43,4,4,0,0,0,47,0,0,4,3,0,2,3,31,0,0,28,31
1858,Assam,2004,06. Cruelty by Husband and Relatives,803,368,1325,126,104,225,1693,1,1232,1206,2790,2498,1945,1325,907,0,0,3823,1779,183,3171,2259,172,1380,1507,3651,785,1951,3526,5785
1859,Bihar,2004,06. Cruelty by Husband and Relatives,640,189,1163,57,142,77,1352,0,2400,1150,4044,3720,2679,1163,782,0,0,4883,1654,117,4123,2969,241,1378,1533,11566,999,1895,10609,13578
1860,Chandigarh,2004,06. Cruelty by Husband and Relatives,9,2,53,0,2,35,55,0,31,48,178,136,73,53,11,0,0,189,26,0,134,94,10,40,36,408,44,36,350,444
1861,Chhattisgarh,2004,06. Cruelty by Husband and Relatives,260,15,736,176,125,2,751,0,25,37,3013,2838,741,736,385,0,0,3574,1008,452,2267,2272,521,12,7,6235,0,1529,5944,8216
1862,Dadra & Nagar Haveli,2004,06. Cruelty by Husband and Relatives,4,0,3,0,0,0,3,0,1,1,19,20,3,3,4,0,0,23,8,0,6,4,0,1,3,31,0,8,35,39
1863,Daman & Diu,2004,06. Cruelty by Husband and Relatives,3,0,3,0,0,0,3,0,1,0,6,6,4,3,3,0,0,9,12,0,8,6,0,0,2,10,0,12,16,22
1864,Delhi,2004,06. Cruelty by Husband and Relatives,352,7,636,0,240,4,643,1,1517,911,634,590,1254,636,592,0,0,1226,352,0,2435,2033,240,489,882,8303,9,592,6862,8895
1865,Goa,2004,06. Cruelty by Husband and Relatives,5,4,15,1,1,0,19,0,12,14,46,38,17,15,6,0,0,53,21,8,45,45,1,28,27,116,1,22,101,146
1866,Gujarat,2004,06. Cruelty by Husband and Relatives,1430,24,3861,311,86,38,3885,3,255,226,21416,19382,3955,3861,1516,0,0,23243,4335,849,12236,12219,135,503,505,62546,15,4470,55646,67865
1867,Haryana,2004,06. Cruelty by Husband and Relatives,773,249,1105,2,123,559,1354,0,259,146,3571,3364,2026,1105,896,0,0,4469,2985,6,3427,3289,473,155,291,10544,2,3458,10719,14008
1868,Himachal Pradesh,2004,06. Cruelty by Husband and Relatives,167,2,220,41,17,23,222,0,43,36,1017,1022,252,220,184,0,0,1242,278,81,534,493,21,55,77,2258,19,299,2145,2638
1869,Jammu & Kashmir,2004,06. Cruelty by Husband and Relatives,16,2,71,13,4,6,73,0,24,21,116,78,82,71,20,0,0,149,33,28,172,170,0,2,4,329,0,33,220,390
1870,Jharkhand,2004,06. Cruelty by Husband and Relatives,264,45,461,47,47,5,506,0,564,487,2083,1980,588,461,311,0,0,2441,603,75,1025,1076,147,349,214,1586,84,750,1335,2411
1871,Karnataka,2004,06. Cruelty by Husband and Relatives,1294,64,1286,63,65,169,1350,26,317,274,4244,4380,1588,1286,1359,0,0,5666,2215,209,2795,2791,162,470,358,7744,116,2377,7539,10330
1872,Kerala,2004,06. Cruelty by Husband and Relatives,1564,66,2805,181,160,331,2871,68,844,892,9380,8480,3222,2805,1724,0,0,11285,3650,317,5637,5603,299,888,840,17793,82,3949,16456,22059
1873,Lakshadweep,2004,06. Cruelty by Husband and Relatives,0,0,1,0,0,0,1,0,1,1,1,0,1,1,0,0,0,1,0,0,1,0,0,0,1,0,0,0,0,0
1874,Madhya Pradesh,2004,06. Cruelty by Husband and Relatives,1317,17,3403,784,739,15,3420,0,110,109,11098,10535,3436,3403,2056,0,0,13938,2964,2248,10310,10305,1755,97,102,32493,0,4719,29155,39460
1875,Maharashtra,2004,06. Cruelty by Husband and Relatives,4060,25,5526,698,162,36,5551,1,946,888,40689,40083,5646,5526,4222,0,0,45609,13393,2043,20490,20116,506,1756,2110,130274,20,13899,126100,146216
1876,Manipur,2004,06. Cruelty by Husband and Relatives,0,2,2,0,0,0,4,0,10,12,3,1,2,2,0,0,0,3,0,0,0,2,0,15,9,2,4,0,0,2
1877,Meghalaya,2004,06. Cruelty by Husband and Relatives,0,3,1,1,0,0,4,0,4,3,7,7,5,1,0,0,0,8,0,1,3,1,0,0,0,7,2,0,7,8
1878,Mizoram,2004,06. Cruelty by Husband and Relatives,0,0,0,0,1,0,0,0,0,0,3,4,0,0,1,0,0,4,0,0,0,0,1,0,0,0,0,1,1,1
1879,Nagaland,2004,06. Cruelty by Husband and Relatives,0,0,1,0,2,0,1,0,0,1,0,1,0,1,2,0,0,2,0,0,0,0,0,0,0,0,0,0,0,0
1880,Odisha,2004,06. Cruelty by Husband and Relatives,684,23,1131,4,115,46,1154,0,422,431,4544,4216,1192,1131,799,0,1,5347,1144,15,2086,2043,219,148,191,7564,0,1363,6899,8942
1881,Puducherry,2004,06. Cruelty by Husband and Relatives,7,0,4,0,0,1,4,0,0,3,7,10,2,4,7,0,0,14,9,0,1,2,0,1,0,7,0,9,14,16
1882,Punjab,2004,06. Cruelty by Husband and Relatives,295,172,597,29,95,102,769,12,593,675,1948,1770,801,597,390,0,0,2367,1046,98,1939,2073,388,1986,1463,6029,389,1434,5488,7561
1883,Rajasthan,2004,06. Cruelty by Husband and Relatives,1306,19,4100,448,1016,2729,4119,0,339,406,13742,12412,6781,4100,2322,0,0,16512,3365,885,8116,8118,2333,54,52,28326,0,5698,26791,34909
1884,Sikkim,2004,06. Cruelty by Husband and Relatives,1,0,1,1,0,0,1,0,0,0,1,2,1,1,1,0,0,3,0,4,1,1,0,1,1,0,0,0,3,4
1885,Tamil Nadu,2004,06. Cruelty by Husband and Relatives,621,44,1316,96,181,106,1360,51,248,328,2787,2369,1437,1316,802,0,0,3685,1586,77,2540,2755,359,657,416,4790,26,1945,4057,6812
1886,Tripura,2004,06. Cruelty by Husband and Relatives,118,44,278,0,35,5,322,0,135,160,562,437,302,278,153,0,0,715,154,62,493,479,71,140,44,562,110,225,370,849
1887,Uttar Pradesh,2004,06. Cruelty by Husband and Relatives,1006,899,3356,831,1329,389,4255,0,676,370,11197,11007,4950,3356,2335,0,0,14363,3610,2660,14394,12515,4435,848,1677,43636,1050,8045,41826,54341
1888,Uttarakhand,2004,06. Cruelty by Husband and Relatives,38,53,320,26,61,27,373,0,65,60,725,530,405,320,99,0,0,850,117,47,1454,1108,282,161,274,2390,233,399,1728,2836
1889,West Bengal,2004,06. Cruelty by Husband and Relatives,932,273,5974,7,125,19,6247,2,3083,3017,30655,25745,6334,5974,1057,0,0,31719,3588,11,10212,8974,284,4573,4813,40569,998,3872,35478,44452
1890,Andaman & Nicobar Islands,2005,06. Cruelty by Husband and Relatives,0,3,1,0,0,0,4,0,4,3,12,11,5,1,0,0,0,12,0,0,7,5,0,10,12,29,0,0,24,29
1891,Andhra Pradesh,2005,06. Cruelty by Husband and Relatives,3276,209,6991,1570,603,1549,7200,0,2579,2632,11656,10114,8696,6991,3879,0,0,17105,6777,3357,15409,15475,1797,4671,4172,25948,433,8574,22404,37879
1892,Arunachal Pradesh,2005,06. Cruelty by Husband and Relatives,2,2,7,0,1,0,9,0,4,4,51,47,9,7,3,0,0,54,2,0,12,9,1,3,4,37,2,3,31,40
1893,Assam,2005,06. Cruelty by Husband and Relatives,939,501,1480,148,148,196,1981,0,1261,1232,3035,2790,2206,1480,1087,0,0,4270,1591,147,3439,2362,216,1507,1666,4059,918,1807,3651,6013
1894,Bihar,2005,06. Cruelty by Husband and Relatives,687,134,1193,48,163,55,1327,0,2592,2400,4339,4044,1574,1193,850,0,0,5237,1655,109,3151,2528,250,1533,1879,12080,277,1905,11566,14094
1895,Chandigarh,2005,06. Cruelty by Husband and Relatives,10,2,67,0,0,4,69,0,33,31,235,178,75,67,10,0,0,245,21,0,142,123,0,36,49,510,6,21,408,531
1896,Chhattisgarh,2005,06. Cruelty by Husband and Relatives,244,18,693,109,183,0,711,0,46,25,3170,3013,732,693,427,0,0,3706,791,636,1923,1902,501,7,28,6209,0,1292,6235,8137
1897,Dadra & Nagar Haveli,2005,06. Cruelty by Husband and Relatives,6,0,4,0,0,0,4,0,2,1,17,19,5,4,6,0,0,23,8,0,13,11,0,3,5,34,0,8,31,42
1898,Daman & Diu,2005,06. Cruelty by Husband and Relatives,1,0,4,0,0,0,4,0,0,1,9,6,3,4,1,0,0,10,3,0,7,9,0,2,0,16,0,3,10,19
1899,Delhi,2005,06. Cruelty by Husband and Relatives,324,36,703,0,84,2,739,7,2093,1517,929,634,1324,703,408,0,0,1337,588,0,2572,2511,109,882,929,10117,14,697,8303,10814
1900,Goa,2005,06. Cruelty by Husband and Relatives,4,2,10,1,0,0,12,0,11,12,51,46,11,10,4,0,0,56,8,3,14,22,0,27,12,127,7,8,116,138
1901,Gujarat,2005,06. Cruelty by Husband and Relatives,1650,26,3989,264,135,28,4015,1,301,255,23356,21416,4090,3989,1785,0,0,25405,4515,736,13272,13161,300,505,615,70156,1,4815,62546,75707
1902,Haryana,2005,06. Cruelty by Husband and Relatives,722,208,1181,6,92,603,1389,0,342,259,3932,3571,2075,1181,814,0,0,4752,2227,46,3303,3299,258,291,295,11312,0,2485,10544,13843
1903,Himachal Pradesh,2005,06. Cruelty by Husband and Relatives,202,1,211,57,12,20,212,0,39,43,957,1017,228,211,214,0,0,1228,481,120,541,539,25,77,79,2171,0,506,2258,2797
1904,Jammu & Kashmir,2005,06. Cruelty by Husband and Relatives,22,0,64,16,0,13,64,0,23,24,142,116,76,64,22,0,0,180,56,38,130,124,0,4,3,359,7,56,329,453
1905,Jharkhand,2005,06. Cruelty by Husband and Relatives,989,53,403,42,120,7,456,0,691,564,1335,2083,590,403,1109,0,0,2486,466,134,965,473,221,214,653,1238,53,687,1586,2059
1906,Karnataka,2005,06. Cruelty by Husband and Relatives,1465,64,1536,100,74,189,1600,37,359,317,4141,4244,1883,1536,1539,0,15,5780,2854,165,3334,3257,141,358,329,7841,106,2995,7744,11001
1907,Kerala,2005,06. Cruelty by Husband and Relatives,1801,62,2812,102,136,295,2874,0,958,844,10153,9380,3283,2812,1937,0,0,12192,3907,174,6287,5810,297,840,1152,19225,165,4204,17793,23603
1908,Lakshadweep,2005,06. Cruelty by Husband and Relatives,0,0,1,0,0,0,1,0,0,1,2,1,0,1,0,0,0,2,0,0,0,0,0,1,1,0,0,0,0,0
1909,Madhya Pradesh,2005,06. Cruelty by Husband and Relatives,1403,23,2909,819,665,4,2932,0,163,110,11120,11098,2989,2909,2068,0,0,14007,4135,2210,8498,8533,1901,102,67,32780,0,6036,32493,41026
1910,Maharashtra,2005,06. Cruelty by Husband and Relatives,4062,26,6076,565,161,54,6102,0,1023,946,41976,40689,6233,6076,4223,1,0,46764,14055,1841,22959,22607,334,2110,2453,136651,9,14389,130274,152881
1911,Manipur,2005,06. Cruelty by Husband and Relatives,0,7,1,0,0,0,8,0,22,10,4,3,20,1,0,0,0,4,0,0,18,1,0,9,13,3,13,0,2,3
1912,Meghalaya,2005,06. Cruelty by Husband and Relatives,3,3,2,0,0,0,5,0,2,4,6,7,3,2,3,0,0,9,3,0,3,1,0,0,1,5,1,3,7,8
1913,Mizoram,2005,06. Cruelty by Husband and Relatives,0,0,0,1,1,0,0,0,0,0,1,3,0,0,1,0,0,3,0,0,0,0,0,0,0,0,0,0,0,0
1914,Nagaland,2005,06. Cruelty by Husband and Relatives,0,0,0,0,0,0,0,0,0,0,0,0,0,0,0,0,0,0,0,0,0,0,0,0,0,0,0,0,0,0
1915,Odisha,2005,06. Cruelty by Husband and Relatives,578,28,1388,0,86,53,1416,1,623,422,5268,4544,1671,1388,664,0,0,5932,1239,0,2671,2632,185,191,222,8772,8,1424,7564,10196
1916,Puducherry,2005,06. Cruelty by Husband and Relatives,2,0,3,0,0,0,3,1,2,0,8,7,6,3,2,0,0,10,2,0,3,3,0,0,0,8,0,2,7,10
1917,Punjab,2005,06. Cruelty by Husband and Relatives,271,117,510,26,48,89,627,11,595,593,2113,1948,729,510,319,0,0,2458,749,123,1544,1469,175,1463,1417,6451,121,924,6029,7498
1918,Rajasthan,2005,06. Cruelty by Husband and Relatives,1262,35,3621,654,822,2408,3656,0,272,339,14625,13742,5997,3621,2084,0,0,17363,2380,1283,6799,6812,1545,52,39,29930,0,3925,28326,35138
1919,Sikkim,2005,06. Cruelty by Husband and Relatives,0,2,0,0,1,0,2,0,2,0,0,1,4,0,1,0,0,1,0,0,3,0,0,1,2,0,2,0,0,0
1920,Tamil Nadu,2005,06. Cruelty by Husband and Relatives,1028,66,1307,12,196,180,1373,8,337,248,2858,2787,1650,1307,1224,0,0,4094,1731,28,2606,2384,338,416,544,5077,94,2069,4790,7174
1921,Tripura,2005,06. Cruelty by Husband and Relatives,200,43,402,0,43,2,445,0,127,135,721,562,439,402,243,0,0,964,473,0,882,728,95,44,186,722,12,568,562,1290
1922,Uttar Pradesh,2005,06. Cruelty by Husband and Relatives,1092,836,3375,547,1452,349,4211,0,621,676,11481,11197,4505,3375,2544,0,0,14572,4232,2201,14154,13279,5210,1677,1874,45272,678,9442,43636,56915
1923,Uttarakhand,2005,06. Cruelty by Husband and Relatives,42,48,185,61,47,26,233,0,78,65,760,725,272,185,89,0,0,910,105,65,698,638,113,274,205,2745,129,218,2390,3028
1924,West Bengal,2005,06. Cruelty by Husband and Relatives,1840,185,6699,21,466,15,6884,4,3116,3083,35027,30655,6936,6699,2306,0,0,37354,4859,31,12201,10946,571,4813,5132,46054,936,5430,40569,51515
1925,Andaman & Nicobar Islands,2006,06. Cruelty by Husband and Relatives,0,2,8,0,0,0,10,0,1,4,20,12,7,8,0,0,0,20,0,0,7,16,0,12,3,45,0,0,29,45
1926,Andhra Pradesh,2006,06. Cruelty by Husband and Relatives,3163,137,6258,1905,687,1234,6395,0,4114,2579,12157,11656,9164,6258,3850,2,0,17912,8908,4610,15531,13663,1533,4172,5428,24560,612,10441,25948,39611
1927,Arunachal Pradesh,2006,06. Cruelty by Husband and Relatives,2,5,8,2,3,0,13,0,5,4,52,51,14,8,5,0,0,59,2,2,8,9,3,4,2,39,1,5,37,46
1928,Assam,2006,06. Cruelty by Husband and Relatives,943,530,1476,125,235,230,2006,0,1573,1261,3208,3035,2548,1476,1178,0,0,4511,1496,198,3200,2081,309,1666,1809,4137,976,1805,4059,6140
1929,Bihar,2006,06. Cruelty by Husband and Relatives,889,233,1237,180,206,93,1470,0,2718,2592,4301,4339,1689,1237,1095,0,0,5576,2066,348,3124,2609,490,1879,2228,11785,166,2556,12080,14689
1930,Chandigarh,2006,06. Cruelty by Husband and Relatives,18,23,40,0,0,13,63,0,59,33,257,235,102,40,18,0,0,275,29,0,190,105,0,49,64,586,70,29,510,615
1931,Chhattisgarh,2006,06. Cruelty by Husband and Relatives,258,5,705,39,186,1,710,0,52,46,3392,3170,717,705,444,0,0,3875,830,109,1932,1893,548,28,67,6615,0,1378,6209,8102
1932,Dadra & Nagar Haveli,2006,06. Cruelty by Husband and Relatives,3,0,5,0,0,0,5,0,2,2,19,17,5,5,3,0,0,22,8,0,6,10,0,5,1,36,0,8,34,44
1933,Daman & Diu,2006,06. Cruelty by Husband and Relatives,1,0,2,0,0,0,2,0,0,0,11,10,2,2,1,0,0,12,8,0,14,14,0,0,0,22,0,8,16,30
1934,Delhi,2006,06. Cruelty by Husband and Relatives,401,44,739,0,113,7,783,13,3018,2093,1154,929,1728,739,514,0,0,1668,403,0,3256,3088,167,929,1077,12635,20,570,10117,13205
1935,Goa,2006,06. Cruelty by Husband and Relatives,5,4,10,0,0,0,14,0,11,11,56,51,14,10,5,0,0,61,10,0,34,23,0,12,19,140,4,10,127,150
1936,Gujarat,2006,06. Cruelty by Husband and Relatives,1656,31,4674,279,95,21,4705,2,550,301,26000,23356,4977,4674,1751,0,0,28030,4955,1020,14878,14287,204,615,1203,78264,3,5159,70156,84443
1937,Haryana,2006,06. Cruelty by Husband and Relatives,612,177,1329,15,100,642,1506,0,448,342,4534,3932,2254,1329,712,0,0,5261,1872,47,3538,3455,327,295,378,12521,0,2199,11312,14767
1938,Himachal Pradesh,2006,06. Cruelty by Husband and Relatives,130,0,205,68,11,26,205,0,67,39,953,957,259,205,141,0,0,1162,258,167,506,497,22,79,84,2221,4,280,2171,2668
1939,Jammu & Kashmir,2006,06. Cruelty by Husband and Relatives,24,1,100,34,2,14,101,0,43,23,182,142,135,100,26,0,0,242,41,60,222,222,3,3,3,477,0,44,359,581
1940,Jharkhand,2006,06. Cruelty by Husband and Relatives,533,41,462,34,259,7,503,0,849,691,971,1335,668,462,792,0,0,1797,76,182,1141,678,0,653,1081,1658,35,76,1238,1916
1941,Karnataka,2006,06. Cruelty by Husband and Relatives,1621,47,1829,276,97,205,1876,24,372,359,3976,4141,2129,1829,1718,0,11,5970,3315,354,3488,3359,185,329,364,7346,94,3500,7841,11200
1942,Kerala,2006,06. Cruelty by Husband and Relatives,1906,80,3200,141,239,312,3280,0,1074,958,11067,10153,3708,3200,2145,0,0,13353,5172,198,6771,6461,507,1152,1419,19809,43,5679,19225,25686
1943,Lakshadweep,2006,06. Cruelty by Husband and Relatives,0,0,0,0,0,0,0,0,1,0,1,1,1,0,0,0,0,1,0,0,1,0,0,0,1,0,0,0,0,0
1944,Madhya Pradesh,2006,06. Cruelty by Husband and Relatives,1020,39,2938,677,1001,9,2977,0,166,163,11360,11120,2989,2938,2021,0,0,14058,2837,1863,8416,8406,1941,67,77,34545,0,4778,32780,41186
1945,Maharashtra,2006,06. Cruelty by Husband and Relatives,3480,39,6189,508,134,153,6228,1,1379,1023,44042,41976,6738,6189,3614,1,0,48164,11943,1288,24060,22924,424,2453,3575,145920,14,12367,136651,159575
1946,Manipur,2006,06. Cruelty by Husband and Relatives,0,4,0,0,0,0,4,0,28,22,4,4,10,0,0,0,0,4,0,0,6,0,0,13,17,3,2,0,3,3
1947,Meghalaya,2006,06. Cruelty by Husband and Relatives,0,4,6,0,0,0,10,0,5,2,12,6,13,6,0,0,0,12,0,0,8,5,0,1,4,10,0,0,5,10
1948,Mizoram,2006,06. Cruelty by Husband and Relatives,0,0,0,0,1,0,0,0,1,0,0,1,1,0,1,0,0,1,0,0,0,0,0,0,0,0,0,0,0,0
1949,Nagaland,2006,06. Cruelty by Husband and Relatives,0,0,2,0,1,0,2,0,1,0,1,0,3,2,1,0,0,2,1,0,5,4,3,0,1,0,0,4,0,4
1950,Odisha,2006,06. Cruelty by Husband and Relatives,640,15,1103,0,96,65,1118,1,133,623,5635,5268,694,1103,736,0,0,6371,1058,0,2661,2522,241,222,359,9995,2,1299,8772,11294
1951,Puducherry,2006,06. Cruelty by Husband and Relatives,3,0,12,0,4,0,12,0,9,2,13,8,19,12,7,0,0,20,3,0,31,27,5,0,4,27,0,8,8,35
1952,Punjab,2006,06. Cruelty by Husband and Relatives,241,107,594,11,67,76,701,16,603,595,2388,2113,801,594,308,0,0,2707,811,30,1683,1377,276,1417,1578,6711,145,1087,6451,7828
1953,Rajasthan,2006,06. Cruelty by Husband and Relatives,1733,80,4223,683,1054,2777,4303,1,229,272,15378,14625,7038,4223,2787,0,0,18848,3402,1265,8277,8288,2153,39,28,31398,0,5555,29930,38218
1954,Sikkim,2006,06. Cruelty by Husband and Relatives,1,0,3,1,1,0,3,0,5,2,0,0,6,3,2,0,0,3,1,1,4,3,1,2,3,0,0,2,0,3
1955,Tamil Nadu,2006,06. Cruelty by Husband and Relatives,808,68,1081,15,162,83,1149,32,317,337,2954,2858,1248,1081,970,0,4,3939,1964,19,2392,2355,480,544,504,4969,77,2444,5077,7432
1956,Tripura,2006,06. Cruelty by Husband and Relatives,194,34,455,0,50,0,489,0,109,127,932,721,471,455,244,0,0,1176,470,0,857,564,110,186,184,706,295,580,722,1286
1957,Uttar Pradesh,2006,06. Cruelty by Husband and Relatives,1174,934,3782,493,1559,337,4716,0,772,621,12037,11481,5204,3782,2733,0,0,15263,4084,1826,14590,13286,5630,1874,1923,47018,1255,9714,45272,58558
1958,Uttarakhand,2006,06. Cruelty by Husband and Relatives,37,72,268,136,25,22,340,0,74,78,830,760,358,268,62,0,0,1028,132,267,989,828,83,205,265,3091,101,215,2745,3573
1959,West Bengal,2006,06. Cruelty by Husband and Relatives,2908,372,6941,57,469,38,7313,4,3175,3116,38534,35027,7414,6941,3377,0,0,41968,5142,116,15354,12218,1350,5132,7375,51664,893,6492,46054,58272
1960,Andaman & Nicobar Islands,2007,06. Cruelty by Husband and Relatives,2,2,10,0,1,0,12,0,7,1,27,20,18,10,3,0,0,30,6,0,34,14,4,3,23,49,0,10,45,59
1961,Andhra Pradesh,2007,06. Cruelty by Husband and Relatives,3605,152,9738,2503,979,1758,9890,0,3801,4114,14808,12157,11335,9738,4584,0,0,21895,8737,3013,18016,17322,2495,5428,5537,27637,585,11232,24560,41882
1962,Arunachal Pradesh,2007,06. Cruelty by Husband and Relatives,2,4,16,0,0,0,20,0,5,5,66,52,20,16,2,0,0,68,2,0,18,16,0,2,2,53,2,2,39,55
1963,Assam,2007,06. Cruelty by Husband and Relatives,1044,453,1652,86,247,420,2105,0,2048,1573,3483,3208,3000,1652,1291,0,0,4860,1734,239,3818,2479,265,1809,2103,4378,1045,1999,4137,6616
1964,Bihar,2007,06. Cruelty by Husband and Relatives,853,237,1507,136,154,167,1744,0,2442,2718,4665,4301,1635,1507,1007,0,0,5808,2269,344,3973,2968,304,2228,3059,11836,174,2573,11785,14753
1965,Chandigarh,2007,06. Cruelty by Husband and Relatives,20,22,53,0,1,14,75,0,82,59,289,257,112,53,21,0,0,310,44,0,143,108,1,64,76,649,23,45,586,694
1966,Chhattisgarh,2007,06. Cruelty by Husband and Relatives,266,7,806,118,116,5,813,0,58,52,3698,3392,824,806,382,0,0,4198,791,317,2195,2149,294,67,113,7362,0,1085,6615,8764
1967,Dadra & Nagar Haveli,2007,06. Cruelty by Husband and Relatives,2,0,3,0,0,0,3,0,2,2,20,19,3,3,2,0,0,22,3,0,3,4,0,1,0,37,0,3,36,40
1968,Daman & Diu,2007,06. Cruelty by Husband and Relatives,0,0,3,0,0,0,3,0,0,0,14,11,3,3,0,0,0,14,0,0,19,17,0,0,0,39,2,0,22,39
1969,Delhi,2007,06. Cruelty by Husband and Relatives,389,42,699,0,126,12,741,6,4045,3018,1338,1154,1787,699,515,0,1,1853,416,0,2688,2153,188,1077,1593,14184,19,604,12635,14788
1970,Goa,2007,06. Cruelty by Husband and Relatives,11,1,9,1,1,0,10,0,15,11,52,56,14,9,12,0,0,65,35,4,47,27,1,19,35,127,4,36,140,167
1971,Gujarat,2007,06. Cruelty by Husband and Relatives,1988,34,5694,265,151,18,5728,4,626,550,29290,26000,5827,5694,2139,0,1,31694,5757,910,18050,18053,385,1203,1200,89265,0,6142,78264,96317
1972,Haryana,2007,06. Cruelty by Husband and Relatives,674,185,1493,20,79,641,1678,0,541,448,5254,4534,2412,1493,753,0,0,6027,2037,65,3880,3676,255,378,582,13840,0,2292,12521,16197
1973,Himachal Pradesh,2007,06. Cruelty by Husband and Relatives,159,3,292,67,10,19,295,0,95,67,1009,953,342,292,169,0,0,1245,330,135,718,673,18,84,129,2411,0,348,2221,2894
1974,Jammu & Kashmir,2007,06. Cruelty by Husband and Relatives,35,1,124,21,0,22,125,0,72,43,250,182,176,124,35,0,0,306,66,45,320,321,0,3,2,687,0,66,477,798
1975,Jharkhand,2007,06. Cruelty by Husband and Relatives,338,51,539,39,130,50,590,0,1010,849,1003,971,801,539,468,0,0,1510,845,97,1193,1078,211,1081,1076,1583,120,1056,1658,2736
1976,Karnataka,2007,06. Cruelty by Husband and Relatives,1379,112,1981,103,91,254,2093,31,501,372,4383,3976,2507,1981,1470,1,0,5956,3086,191,4182,4032,220,364,418,7881,96,3306,7346,11378
1977,Kerala,2007,06. Cruelty by Husband and Relatives,2358,92,3626,122,138,309,3718,0,1046,1074,12075,11067,3999,3626,2496,0,0,14693,5162,230,6626,6650,250,1419,1388,20817,7,5412,19809,26459
1978,Lakshadweep,2007,06. Cruelty by Husband and Relatives,0,0,0,0,0,0,0,0,3,1,1,1,2,0,0,0,0,1,0,0,0,0,0,1,1,0,0,0,0,0
1979,Madhya Pradesh,2007,06. Cruelty by Husband and Relatives,1403,28,3275,827,890,12,3303,0,145,166,11515,11360,3294,3275,2293,0,0,14635,3642,2360,9424,9407,2185,77,94,35765,0,5827,34545,43952
1980,Maharashtra,2007,06. Cruelty by Husband and Relatives,3722,58,6647,501,121,203,6705,0,1827,1379,46345,44042,7356,6647,3843,0,0,50689,12956,1459,24745,23719,429,3575,4570,154795,31,13385,145920,169639
1981,Manipur,2007,06. Cruelty by Husband and Relatives,0,4,0,0,0,0,4,0,39,28,4,4,15,0,0,0,0,4,0,0,15,0,0,17,13,3,19,0,3,3
1982,Meghalaya,2007,06. Cruelty by Husband and Relatives,0,4,5,1,0,0,9,0,15,5,16,12,19,5,0,0,0,17,0,1,13,5,0,4,8,14,4,0,10,15
1983,Mizoram,2007,06. Cruelty by Husband and Relatives,0,0,2,0,0,0,2,0,1,1,2,0,2,2,0,0,0,2,0,0,1,1,0,0,0,1,0,0,0,1
1984,Nagaland,2007,06. Cruelty by Husband and Relatives,0,0,1,0,0,0,1,0,0,1,2,1,0,1,0,0,0,2,0,0,0,1,0,1,0,1,0,0,0,1
1985,Odisha,2007,06. Cruelty by Husband and Relatives,571,18,758,0,131,26,776,1,58,133,5691,5635,728,758,702,0,0,6393,774,0,2089,1805,434,359,643,10592,0,1208,9995,11800
1986,Puducherry,2007,06. Cruelty by Husband and Relatives,5,0,22,0,0,0,22,0,4,9,30,13,17,22,5,0,0,35,10,0,39,41,0,4,2,58,0,10,27,68
1987,Punjab,2007,06. Cruelty by Husband and Relatives,254,130,606,6,64,74,736,0,764,603,2670,2388,971,606,318,0,0,2994,1045,22,1911,1522,237,1578,1782,6929,185,1282,6711,8233
1988,Rajasthan,2007,06. Cruelty by Husband and Relatives,1539,78,4780,669,1129,3302,4858,1,238,229,16820,15378,8170,4780,2668,1,0,20157,2962,1420,8486,8473,2235,28,41,33254,0,5197,31398,39871
1989,Sikkim,2007,06. Cruelty by Husband and Relatives,0,1,2,0,2,0,3,0,9,5,0,0,7,2,2,0,0,2,0,0,8,7,2,3,4,5,0,2,0,7
1990,Tamil Nadu,2007,06. Cruelty by Husband and Relatives,766,132,1489,7,206,133,1621,10,529,317,3464,2954,1976,1489,972,0,0,4443,1818,13,3538,3145,431,504,806,5852,91,2249,4969,8114
1991,Tripura,2007,06. Cruelty by Husband and Relatives,391,43,559,0,63,0,602,0,52,109,1037,932,545,559,454,0,0,1491,526,78,618,735,110,184,31,727,36,636,706,1441
1992,Uttar Pradesh,2007,06. Cruelty by Husband and Relatives,1667,1816,5013,635,1764,730,6829,0,863,772,12984,12037,7650,5013,3431,0,0,17050,7137,1895,23465,18692,7214,1923,2709,49464,3987,14351,47018,65710
1993,Uttarakhand,2007,06. Cruelty by Husband and Relatives,65,79,319,188,75,37,398,0,102,74,821,830,463,319,140,0,0,1149,198,380,1437,1000,366,265,379,3147,323,564,3091,4091
1994,West Bengal,2007,06. Cruelty by Husband and Relatives,2283,196,9448,49,162,9,9644,2,3420,3175,45488,38534,9900,9448,2445,0,0,47982,6714,226,14700,15030,293,7375,6625,59461,420,7007,51664,66694
1995,Andaman & Nicobar Islands,2008,06. Cruelty by Husband and Relatives,2,4,20,0,0,0,24,0,9,7,45,27,26,20,2,0,0,47,2,0,23,33,0,23,13,80,0,2,49,82
1996,Andhra Pradesh,2008,06. Cruelty by Husband and Relatives,3029,163,8762,3400,697,1464,8925,0,3718,3801,16444,14808,10306,8762,3726,0,0,23570,7448,6870,19398,19011,1578,5537,5206,30752,718,9026,27637,46648
1997,Arunachal Pradesh,2008,06. Cruelty by Husband and Relatives,2,6,9,0,0,0,15,0,3,5,73,66,13,9,2,0,0,75,3,0,12,9,0,2,4,59,1,3,53,62
1998,Assam,2008,06. Cruelty by Husband and Relatives,828,599,2154,136,141,283,2753,0,2490,2048,4532,3483,3478,2154,969,0,0,5637,1620,316,3577,2489,263,2103,2392,4668,799,1883,4378,6867
1999,Bihar,2008,06. Cruelty by Husband and Relatives,706,224,1537,141,197,229,1761,0,2444,2442,5158,4665,1992,1537,903,0,0,6202,2043,330,3732,3138,357,3059,3628,12244,25,2400,11836,14974
2000,Chandigarh,2008,06. Cruelty by Husband and Relatives,11,8,27,0,1,16,35,0,80,82,304,289,49,27,12,0,0,316,40,0,80,43,3,76,88,649,25,43,649,692
2001,Chhattisgarh,2008,06. Cruelty by Husband and Relatives,281,8,858,71,113,1,866,5,83,58,4091,3698,897,858,394,0,0,4556,852,195,2297,2254,355,113,154,8214,2,1207,7362,9616
2002,Dadra & Nagar Haveli,2008,06. Cruelty by Husband and Relatives,7,0,5,0,0,0,5,0,1,2,18,20,4,5,7,0,0,25,9,0,11,11,0,0,0,39,0,9,37,48
2003,Daman & Diu,2008,06. Cruelty by Husband and Relatives,4,0,4,0,0,0,4,0,1,0,14,14,5,4,4,0,0,18,5,0,20,20,0,0,0,54,0,5,39,59
2004,Delhi,2008,06. Cruelty by Husband and Relatives,312,186,879,0,43,49,1065,12,4301,4045,1862,1338,1387,879,355,0,5,2217,878,0,725,1340,127,1593,465,14519,513,1005,14184,15524
2005,Goa,2008,06. Cruelty by Husband and Relatives,9,2,11,0,0,0,13,0,14,15,54,52,12,11,9,0,0,63,25,0,23,29,0,35,24,131,5,25,127,156
2006,Gujarat,2008,06. Cruelty by Husband and Relatives,2561,39,6073,360,140,21,6112,7,580,626,32302,29290,6094,6073,2701,0,0,35363,7833,1128,18602,18640,360,1200,1162,98584,0,8193,89265,107905
2007,Haryana,2008,06. Cruelty by Husband and Relatives,935,263,1556,39,102,648,1819,0,509,541,5734,5254,2435,1556,1037,0,0,6810,2549,107,3712,3792,274,582,502,14702,0,2823,13840,17632
2008,Himachal Pradesh,2008,06. Cruelty by Husband and Relatives,128,1,296,31,9,36,297,0,105,95,1137,1009,343,296,137,0,0,1305,301,62,731,710,19,129,148,2739,2,320,2411,3121
2009,Jammu & Kashmir,2008,06. Cruelty by Husband and Relatives,28,0,125,31,1,17,125,0,92,72,315,250,162,125,29,0,0,375,72,104,290,289,5,2,3,795,0,77,687,976
2010,Jharkhand,2008,06. Cruelty by Husband and Relatives,453,107,708,87,157,17,815,0,1029,1010,1014,1003,851,708,610,0,0,1711,649,104,1651,1359,278,1076,1320,1911,48,927,1583,2942
2011,Karnataka,2008,06. Cruelty by Husband and Relatives,1294,45,2291,88,75,220,2336,34,537,501,5217,4383,2638,2291,1369,0,12,6674,3105,247,4827,4479,219,418,699,8789,67,3324,7881,12360
2012,Kerala,2008,06. Cruelty by Husband and Relatives,2216,119,3653,109,153,282,3772,0,1130,1046,13250,12075,4138,3653,2369,0,0,15728,4533,240,6303,6311,288,1388,1375,22067,5,4821,20817,27128
2013,Lakshadweep,2008,06. Cruelty by Husband and Relatives,0,0,0,0,0,0,0,0,4,3,1,1,1,0,0,0,0,1,0,0,0,0,0,1,1,0,0,0,0,0
2014,Madhya Pradesh,2008,06. Cruelty by Husband and Relatives,1567,27,3091,690,1306,5,3118,0,207,145,11043,11515,3185,3091,2873,0,0,14606,4609,2133,10196,10183,5180,94,107,34026,0,9789,35765,45948
2015,Maharashtra,2008,06. Cruelty by Husband and Relatives,4152,165,7484,761,153,136,7649,0,1871,1827,48763,46345,7829,7484,4305,0,0,53829,14888,2762,25979,25211,439,4570,5329,161917,9,15327,154795,180006
2016,Manipur,2008,06. Cruelty by Husband and Relatives,0,5,0,0,0,0,5,0,62,39,4,4,28,0,0,0,0,4,0,0,12,0,0,13,10,3,15,0,3,3
2017,Meghalaya,2008,06. Cruelty by Husband and Relatives,4,6,5,2,2,0,11,0,36,15,13,16,32,5,6,0,0,21,2,2,29,6,2,8,25,14,6,4,14,20
2018,Mizoram,2008,06. Cruelty by Husband and Relatives,0,0,5,0,2,0,5,0,1,1,5,2,5,5,2,0,0,7,0,0,5,5,2,0,0,4,0,2,1,6
2019,Nagaland,2008,06. Cruelty by Husband and Relatives,1,1,3,0,1,0,4,0,0,0,3,2,4,3,2,0,0,5,1,0,4,2,2,0,2,0,0,3,1,3
2020,Odisha,2008,06. Cruelty by Husband and Relatives,686,15,1067,0,152,57,1082,5,532,58,5920,5691,1618,1067,838,0,0,6758,1126,0,2121,2140,213,643,624,11393,0,1339,10592,12732
2021,Puducherry,2008,06. Cruelty by Husband and Relatives,5,0,6,0,0,1,6,0,9,4,31,30,12,6,5,0,0,36,8,0,16,13,0,2,5,63,0,8,58,71
2022,Punjab,2008,06. Cruelty by Husband and Relatives,286,148,721,1,65,115,869,0,764,764,3039,2670,984,721,351,0,0,3391,892,3,1963,2003,243,1782,1631,7794,111,1135,6929,8932
2023,Rajasthan,2008,06. Cruelty by Husband and Relatives,1512,0,4953,525,1197,3086,4953,0,312,238,18539,16820,8113,4953,2709,0,0,21773,3203,1024,8027,8015,2228,41,53,34814,0,5431,33254,41269
2024,Sikkim,2008,06. Cruelty by Husband and Relatives,0,0,8,0,0,0,8,0,6,9,8,0,5,8,0,0,0,8,0,0,5,8,0,4,1,13,0,0,5,13
2025,Tamil Nadu,2008,06. Cruelty by Husband and Relatives,818,121,1477,10,307,150,1598,0,429,529,3806,3464,1648,1477,1125,0,0,4941,1495,10,3351,3188,602,806,907,6933,62,2097,5852,9040
2026,Tripura,2008,06. Cruelty by Husband and Relatives,271,29,694,25,49,2,723,0,62,52,1386,1037,735,694,320,0,0,1731,445,38,1064,906,34,31,0,1116,189,479,727,1633
2027,Uttar Pradesh,2008,06. Cruelty by Husband and Relatives,2065,1739,5837,730,2345,716,7576,0,883,863,13681,12984,8312,5837,4410,0,0,18821,7767,2375,27984,22114,9232,2709,3226,52204,5353,16999,49464,71578
2028,Uttarakhand,2008,06. Cruelty by Husband and Relatives,83,65,258,38,106,42,323,0,77,102,852,821,340,258,189,0,0,1079,381,175,570,603,550,379,77,2644,269,931,3147,3750
2029,West Bengal,2008,06. Cruelty by Husband and Relatives,2381,279,10225,35,196,23,10504,5,6550,3420,53101,45488,13663,10225,2577,0,1,55713,6495,46,17521,16123,224,6625,7616,68819,407,6719,59461,75584
2030,Andaman & Nicobar Islands,2009,06. Cruelty by Husband and Relatives,3,7,16,0,0,0,23,0,7,9,58,45,21,16,3,0,0,61,3,0,35,38,0,13,10,115,0,3,80,118
2031,Andhra Pradesh,2009,06. Cruelty by Husband and Relatives,4674,291,8981,2869,561,1185,9272,0,4558,3718,17321,16444,11297,8981,5235,0,0,25425,9626,5554,19018,17746,1451,5206,5893,31867,585,11077,30752,48498
2032,Arunachal Pradesh,2009,06. Cruelty by Husband and Relatives,3,0,14,0,3,0,14,0,2,3,81,73,13,14,6,0,0,87,4,0,12,14,3,4,2,66,0,7,59,73
2033,Assam,2009,06. Cruelty by Husband and Relatives,1101,878,2632,212,281,276,3510,9,3093,2490,5570,4532,4398,2632,1382,0,0,7164,1508,182,5753,2933,326,2392,3272,5585,1940,1834,4668,7601
2034,Bihar,2009,06. Cruelty by Husband and Relatives,1139,415,1649,143,169,198,2064,0,2714,2444,5356,5158,2532,1649,1308,0,0,6807,2635,415,4939,3910,474,3628,4617,12630,40,3109,12244,16154
2035,Chandigarh,2009,06. Cruelty by Husband and Relatives,17,1,7,0,7,30,8,0,93,80,287,304,51,7,24,0,0,311,36,0,28,35,15,88,63,633,18,51,649,684
2036,Chhattisgarh,2009,06. Cruelty by Husband and Relatives,387,5,903,64,59,7,908,0,61,83,4484,4091,893,903,446,0,0,4994,997,174,2462,2447,131,154,163,9359,6,1128,8214,10661
2037,Dadra & Nagar Haveli,2009,06. Cruelty by Husband and Relatives,2,0,0,0,0,0,0,0,4,1,16,18,3,0,2,0,0,18,6,0,0,0,0,0,0,33,0,6,39,39
2038,Daman & Diu,2009,06. Cruelty by Husband and Relatives,4,0,2,0,0,0,2,0,2,1,12,14,3,2,4,0,0,16,15,0,4,4,0,0,0,43,0,15,54,58
2039,Delhi,2009,06. Cruelty by Husband and Relatives,218,116,1046,0,78,46,1162,7,4332,4301,2612,1862,1283,1046,296,0,37,2908,480,0,658,1052,103,465,15,14988,56,583,14519,15571
2040,Goa,2009,06. Cruelty by Husband and Relatives,17,4,12,0,0,0,16,0,19,14,49,54,21,12,17,0,0,66,35,0,46,26,0,24,39,122,5,35,131,157
2041,Gujarat,2009,06. Cruelty by Husband and Relatives,2909,38,5392,211,106,17,5430,7,632,580,34468,32302,5506,5392,3015,0,0,37694,8876,1015,17595,17791,623,1162,966,105861,0,9499,98584,116375
2042,Haryana,2009,06. Cruelty by Husband and Relatives,1005,201,1536,14,122,729,1737,0,660,509,6129,5734,2617,1536,1127,0,0,7270,2602,64,3661,3696,309,502,463,15423,4,2911,14702,18398
2043,Himachal Pradesh,2009,06. Cruelty by Husband and Relatives,149,3,301,60,9,35,304,0,50,105,1220,1137,284,301,158,0,0,1438,350,141,648,704,25,148,92,2927,0,375,2739,3443
2044,Jammu & Kashmir,2009,06. Cruelty by Husband and Relatives,19,0,169,49,2,30,169,0,89,92,414,315,196,169,21,0,0,484,51,159,469,468,8,3,4,1045,0,59,795,1263
2045,Jharkhand,2009,06. Cruelty by Husband and Relatives,413,130,809,86,304,17,939,0,783,1029,1020,1014,710,809,717,0,0,1823,756,107,1560,1465,381,1320,1387,2132,28,1137,1911,3376
2046,Karnataka,2009,06. Cruelty by Husband and Relatives,1510,70,2620,238,80,249,2690,44,733,537,6009,5217,3185,2620,1590,0,6,7837,3567,334,5784,5680,207,699,658,10361,145,3774,8789,14469
2047,Kerala,2009,06. Cruelty by Husband and Relatives,2303,73,3923,183,181,188,3996,2,951,1130,14506,13250,4007,3923,2484,0,0,17173,4769,420,5828,6307,423,1375,889,22762,7,5192,22067,28374
2048,Lakshadweep,2009,06. Cruelty by Husband and Relatives,1,1,2,0,0,0,3,0,1,4,2,1,0,2,1,0,0,3,1,0,2,2,0,1,1,1,0,1,0,2
2049,Madhya Pradesh,2009,06. Cruelty by Husband and Relatives,1626,20,4031,858,918,3,4051,0,136,207,11672,11043,3983,4031,2544,0,0,15074,4695,2553,11182,11172,2511,107,117,35439,0,7206,34026,45198
2050,Maharashtra,2009,06. Cruelty by Husband and Relatives,4003,93,7390,582,119,180,7483,1,1888,1871,51449,48763,7681,7390,4122,0,0,56153,14859,1858,29493,28238,323,5329,6578,173115,6,15182,161917,190155
2051,Manipur,2009,06. Cruelty by Husband and Relatives,0,8,0,0,0,0,8,0,79,62,4,4,25,0,0,0,0,4,0,0,25,0,0,10,24,3,11,0,3,3
2052,Meghalaya,2009,06. Cruelty by Husband and Relatives,2,6,10,0,1,0,16,0,44,36,20,13,24,10,3,0,0,23,2,0,6,16,1,25,13,27,2,3,14,30
2053,Mizoram,2009,06. Cruelty by Husband and Relatives,0,0,5,0,10,0,5,0,0,1,0,5,4,5,10,0,0,10,0,0,4,4,8,0,0,0,0,8,4,8
2054,Nagaland,2009,06. Cruelty by Husband and Relatives,0,0,0,0,2,0,0,0,0,0,1,3,0,0,2,0,0,3,0,0,0,2,2,2,0,0,0,2,0,2
2055,Odisha,2009,06. Cruelty by Husband and Relatives,663,14,1427,0,121,63,1441,0,1075,532,6563,5920,2047,1427,784,0,0,7347,1603,0,2915,2825,209,624,714,12406,0,1812,11393,14218
2056,Puducherry,2009,06. Cruelty by Husband and Relatives,14,0,17,0,1,1,17,0,1,9,33,31,10,17,15,0,0,48,26,0,21,26,2,5,0,61,0,28,63,89
2057,Punjab,2009,06. Cruelty by Husband and Relatives,363,151,796,8,209,124,947,0,754,764,3255,3039,1061,796,572,0,0,3835,914,10,1871,1650,420,1631,1700,8100,152,1334,7794,9444
2058,Rajasthan,2009,06. Cruelty by Husband and Relatives,1558,260,5985,593,1275,4115,6245,0,323,312,21098,18539,10371,5985,2833,0,0,24524,2919,1324,9326,9344,2247,53,35,37668,0,5166,34814,44158
2059,Sikkim,2009,06. Cruelty by Husband and Relatives,0,1,8,1,6,0,9,0,3,6,9,8,6,8,6,0,0,16,0,2,12,8,9,1,3,10,2,9,13,21
2060,Tamil Nadu,2009,06. Cruelty by Husband and Relatives,904,207,1112,1,238,114,1319,0,456,429,3775,3806,1460,1112,1142,0,0,4918,2089,1,2697,2714,656,907,834,6901,56,2745,6933,9647
2061,Tripura,2009,06. Cruelty by Husband and Relatives,293,29,778,32,34,0,807,0,70,62,1805,1386,815,778,327,0,0,2164,511,415,1760,1249,57,0,194,1382,317,568,1116,2365
2062,Uttar Pradesh,2009,06. Cruelty by Husband and Relatives,2184,1604,6082,854,2268,747,7686,0,1016,883,14457,13681,8566,6082,4452,0,0,19763,8041,3017,31807,23846,9685,3226,3822,55307,7365,17726,52204,76050
2063,Uttarakhand,2009,06. Cruelty by Husband and Relatives,51,68,294,25,82,16,362,0,60,77,988,852,361,294,133,0,0,1146,135,62,890,787,280,77,146,2954,34,415,2644,3431
2064,West Bengal,2009,06. Cruelty by Husband and Relatives,2408,407,13647,28,134,22,14054,3,8583,6550,64178,53101,16112,13647,2542,0,0,66748,7222,345,13884,13473,231,7616,7426,74494,601,7453,68819,82292
2065,Andaman & Nicobar Islands,2010,06. Cruelty by Husband and Relatives,2,5,9,0,0,0,14,0,2,7,65,58,9,9,2,0,0,67,2,0,12,22,0,10,0,135,0,2,115,137
2066,Andhra Pradesh,2010,06. Cruelty by Husband and Relatives,5343,225,11459,3235,756,1277,11684,7,3670,4558,19445,17321,12080,11459,6099,1,0,28779,10464,5746,21572,22299,1554,5893,4801,36402,365,12018,31867,54166
2067,Arunachal Pradesh,2010,06. Cruelty by Husband and Relatives,2,1,8,0,1,0,9,0,5,2,86,81,12,8,3,0,0,89,2,0,11,8,1,2,3,71,2,3,66,74
2068,Assam,2010,06. Cruelty by Husband and Relatives,1302,883,3155,113,227,467,4038,8,3990,3093,7083,5570,5410,3155,1529,0,0,8725,2010,233,6208,3762,390,3272,3664,6714,2054,2400,5585,9347
2069,Bihar,2010,06. Cruelty by Husband and Relatives,1062,274,1465,172,182,235,1739,0,3011,2714,5405,5356,2271,1465,1244,0,0,6821,2421,405,3850,3630,390,4617,4647,13044,190,2811,12630,16260
2070,Chandigarh,2010,06. Cruelty by Husband and Relatives,60,19,27,0,7,31,46,0,57,93,247,287,41,27,67,0,0,314,77,0,18,20,9,63,32,567,29,86,633,653
2071,Chhattisgarh,2010,06. Cruelty by Husband and Relatives,476,10,834,132,142,6,844,0,72,61,4568,4484,861,834,618,0,0,5318,1169,338,2450,2407,339,163,155,9920,51,1508,9359,11766
2072,Dadra & Nagar Haveli,2010,06. Cruelty by Husband and Relatives,0,0,3,0,2,0,3,0,4,4,17,16,3,3,2,0,0,19,0,0,14,9,3,0,5,39,0,3,33,42
2073,Daman & Diu,2010,06. Cruelty by Husband and Relatives,2,0,2,0,0,0,2,0,3,2,12,12,3,2,2,0,0,14,2,0,6,5,0,0,1,46,0,2,43,48
2074,Delhi,2010,06. Cruelty by Husband and Relatives,352,41,838,0,83,43,879,3,4771,4332,3015,2612,1404,838,435,0,40,3450,719,0,878,838,147,15,5,14960,50,866,14988,15826
2075,Goa,2010,06. Cruelty by Husband and Relatives,8,2,14,0,0,1,16,0,19,19,55,49,17,14,8,0,0,63,12,0,41,42,0,39,32,152,6,12,122,164
2076,Gujarat,2010,06. Cruelty by Husband and Relatives,3091,61,5447,185,110,16,5508,2,706,632,36529,34468,5600,5447,3201,0,0,39915,9050,440,16877,16768,784,966,1075,112355,0,9834,105861,122629
2077,Haryana,2010,06. Cruelty by Husband and Relatives,1251,186,1684,18,131,712,1870,0,798,660,6413,6129,2720,1684,1382,0,0,7813,3631,51,4057,3794,531,463,726,15004,0,4162,15423,19217
2078,Himachal Pradesh,2010,06. Cruelty by Husband and Relatives,102,1,235,51,7,30,236,0,59,50,1295,1220,275,235,109,0,0,1455,309,123,677,664,26,92,105,3133,0,335,2927,3591
2079,Jammu & Kashmir,2010,06. Cruelty by Husband and Relatives,25,1,157,57,8,40,158,0,102,89,481,414,211,157,33,0,0,571,69,161,418,412,6,4,10,1221,0,75,1045,1457
2080,Jharkhand,2010,06. Cruelty by Husband and Relatives,491,84,618,33,177,35,702,0,696,783,937,1020,650,618,668,0,0,1638,1688,35,1600,2361,411,1387,610,2359,16,2099,2132,4493
2081,Karnataka,2010,06. Cruelty by Husband and Relatives,1708,99,2994,69,75,297,3093,41,736,733,7150,6009,3441,2994,1783,1,7,9002,3921,449,6515,5832,183,658,869,11640,472,4104,10361,16193
2082,Kerala,2010,06. Cruelty by Husband and Relatives,2436,54,4461,79,127,194,4515,6,1033,951,16325,14506,4797,4461,2563,0,0,18967,4692,195,7522,7492,222,889,919,25145,0,4914,22762,30254
2083,Lakshadweep,2010,06. Cruelty by Husband and Relatives,0,0,0,0,0,0,0,0,1,1,2,2,0,0,0,0,0,2,0,0,0,0,0,1,1,1,0,0,1,1
2084,Madhya Pradesh,2010,06. Cruelty by Husband and Relatives,1390,23,3669,649,871,3,3692,0,197,136,12430,11672,3756,3669,2261,1,0,15340,4552,2064,10253,10269,2708,117,96,36384,5,7260,35439,45708
2085,Maharashtra,2010,06. Cruelty by Husband and Relatives,4896,74,7354,615,104,104,7428,0,1789,1888,53187,51449,7434,7354,5000,1,1,58802,18221,1786,28261,27819,344,6578,6993,180583,27,18565,173115,200934
2086,Manipur,2010,06. Cruelty by Husband and Relatives,0,4,0,0,0,0,4,0,93,79,4,4,18,0,0,0,0,4,0,0,13,0,0,24,34,3,3,0,3,3
2087,Meghalaya,2010,06. Cruelty by Husband and Relatives,2,0,10,3,0,0,10,0,58,44,25,20,24,10,2,0,0,30,2,3,11,9,0,13,12,31,3,2,27,36
2088,Mizoram,2010,06. Cruelty by Husband and Relatives,0,0,3,0,2,0,3,0,0,0,1,0,3,3,2,0,0,3,0,0,3,3,2,0,0,1,0,2,0,3
2089,Nagaland,2010,06. Cruelty by Husband and Relatives,0,0,1,0,2,0,1,0,0,0,0,1,1,1,2,0,0,2,0,0,3,3,3,0,0,0,0,3,0,3
2090,Odisha,2010,06. Cruelty by Husband and Relatives,1039,22,2164,0,99,56,2186,0,900,1075,7589,6563,2067,2164,1138,0,0,8727,2380,0,4840,4822,258,714,732,14590,0,2638,12406,17228
2091,Puducherry,2010,06. Cruelty by Husband and Relatives,8,0,7,0,0,0,7,0,1,1,32,33,7,7,8,0,0,40,13,0,9,9,0,0,0,57,0,13,61,70
2092,Punjab,2010,06. Cruelty by Husband and Relatives,409,189,845,11,123,157,1034,0,683,711,3393,3091,1163,845,532,0,0,3936,1010,12,2159,2132,355,1676,1580,8144,123,1365,7389,9521
2093,Rajasthan,2010,06. Cruelty by Husband and Relatives,1375,160,6192,795,1042,4755,6352,1,360,323,24078,21098,11145,6192,2417,0,0,27290,2701,1292,9113,9096,2115,35,52,40656,0,4816,37668,46764
2094,Sikkim,2010,06. Cruelty by Husband and Relatives,0,0,3,0,0,0,3,0,3,3,12,9,3,3,0,0,0,12,0,0,4,3,0,3,4,13,0,0,10,13
2095,Tamil Nadu,2010,06. Cruelty by Husband and Relatives,830,165,1165,2,211,154,1330,0,542,456,3897,3775,1570,1165,1041,0,0,4940,1917,2,2981,2860,519,834,918,7323,37,2436,6901,9761
2096,Tripura,2010,06. Cruelty by Husband and Relatives,397,42,781,50,39,4,823,0,180,70,2100,1805,937,781,436,0,0,2586,632,135,1172,873,67,194,321,1421,172,699,1382,2255
2097,Uttar Pradesh,2010,06. Cruelty by Husband and Relatives,2461,1676,5776,259,3024,561,7452,0,981,1016,14489,14457,7978,5776,5485,0,0,20233,10430,1162,29853,22468,11741,3822,3999,54442,7208,22171,55307,77775
2098,Uttarakhand,2010,06. Cruelty by Husband and Relatives,110,70,264,15,64,14,334,0,46,60,1063,988,334,264,174,0,0,1252,586,69,625,588,518,146,156,2369,27,1104,2954,3542
2099,West Bengal,2010,06. Cruelty by Husband and Relatives,2357,461,16946,58,148,35,17407,3,8934,8583,78561,64178,17796,16946,2505,0,0,81124,7768,554,18387,19464,211,7426,5570,85425,779,7979,74494,93958
2100,Andaman & Nicobar Islands,2001,07. Importation of Girls,0,0,0,0,0,0,0,0,0,0,0,0,0,0,0,0,0,0,0,0,0,0,0,0,0,0,0,0,0,0
2101,Andhra Pradesh,2001,07. Importation of Girls,0,1,2,0,0,3,3,0,1,0,2,0,7,2,0,0,0,2,0,0,6,4,0,0,2,4,0,0,0,4
2102,Arunachal Pradesh,2001,07. Importation of Girls,0,0,0,0,0,0,0,0,0,0,0,0,0,0,0,0,0,0,0,0,0,0,0,0,0,0,0,0,0,0
2103,Assam,2001,07. Importation of Girls,0,0,0,0,0,0,0,0,0,0,0,0,0,0,0,0,0,0,0,0,0,0,0,0,0,0,0,0,0,0
2104,Bihar,2001,07. Importation of Girls,5,2,42,0,1,2,44,0,47,10,60,24,83,42,6,0,0,66,14,0,179,100,0,24,97,147,6,14,61,161
2105,Chandigarh,2001,07. Importation of Girls,0,0,0,0,0,0,0,0,0,0,0,0,0,0,0,0,0,0,0,0,0,0,0,0,0,0,0,0,0,0
2106,Chhattisgarh,2001,07. Importation of Girls,0,0,0,0,0,0,0,0,0,0,0,0,0,0,0,0,0,0,0,0,0,0,0,0,0,0,0,0,0,0
2107,Dadra & Nagar Haveli,2001,07. Importation of Girls,0,0,0,0,0,0,0,0,0,0,0,0,0,0,0,0,0,0,0,0,0,0,0,0,0,0,0,0,0,0
2108,Daman & Diu,2001,07. Importation of Girls,0,0,0,0,0,0,0,0,0,0,0,0,0,0,0,0,0,0,0,0,0,0,0,0,0,0,0,0,0,0
2109,Delhi,2001,07. Importation of Girls,0,0,0,0,0,0,0,0,0,0,0,0,0,0,0,0,0,0,0,0,0,0,0,0,0,0,0,0,0,0
2110,Goa,2001,07. Importation of Girls,0,0,0,0,0,0,0,0,0,0,0,0,0,0,0,0,0,0,0,0,0,0,0,0,0,0,0,0,0,0
2111,Gujarat,2001,07. Importation of Girls,0,0,0,0,0,0,0,0,0,0,0,0,0,0,0,0,0,0,0,0,0,0,0,0,0,0,0,0,0,0
2112,Haryana,2001,07. Importation of Girls,0,0,0,0,0,0,0,0,0,0,0,0,0,0,0,0,0,0,0,0,0,0,0,0,0,0,0,0,0,0
2113,Himachal Pradesh,2001,07. Importation of Girls,0,0,0,0,0,0,0,0,0,0,0,0,0,0,0,0,0,0,0,0,0,0,0,0,0,0,0,0,0,0
2114,Jammu & Kashmir,2001,07. Importation of Girls,0,0,0,0,0,0,0,0,0,0,0,0,0,0,0,0,0,0,0,0,0,0,0,0,0,0,0,0,0,0
2115,Jharkhand,2001,07. Importation of Girls,1,0,2,0,2,0,2,0,0,0,9,10,2,2,3,0,0,12,43,0,8,8,27,0,0,19,0,70,81,89
2116,Karnataka,2001,07. Importation of Girls,0,0,0,0,0,0,0,0,0,0,0,0,0,0,0,0,0,0,0,0,0,0,0,0,0,0,0,0,0,0
2117,Kerala,2001,07. Importation of Girls,0,0,0,0,0,0,0,0,0,0,0,0,0,0,0,0,0,0,0,0,0,0,0,0,0,0,0,0,0,0
2118,Lakshadweep,2001,07. Importation of Girls,0,0,0,0,0,0,0,0,0,0,0,0,0,0,0,0,0,0,0,0,0,0,0,0,0,0,0,0,0,0
2119,Madhya Pradesh,2001,07. Importation of Girls,0,0,0,0,0,0,0,0,0,0,0,0,0,0,0,0,0,0,0,0,0,0,0,0,0,0,0,0,0,0
2120,Maharashtra,2001,07. Importation of Girls,0,0,1,0,0,0,1,0,0,0,1,0,1,1,0,0,0,1,0,0,11,11,0,0,0,11,0,0,0,11
2121,Manipur,2001,07. Importation of Girls,0,0,0,0,0,0,0,0,0,0,0,0,0,0,0,0,0,0,0,0,0,0,0,0,0,0,0,0,0,0
2122,Meghalaya,2001,07. Importation of Girls,0,0,0,0,0,0,0,0,0,0,0,0,0,0,0,0,0,0,0,0,0,0,0,0,0,0,0,0,0,0
2123,Mizoram,2001,07. Importation of Girls,0,0,0,0,0,0,0,0,3,0,0,0,3,0,0,0,0,0,0,0,0,0,0,0,0,0,0,0,0,0
2124,Nagaland,2001,07. Importation of Girls,0,0,0,0,0,0,0,0,0,0,0,0,0,0,0,0,0,0,0,0,0,0,0,0,0,0,0,0,0,0
2125,Odisha,2001,07. Importation of Girls,0,0,2,0,0,0,2,0,0,2,2,0,0,2,0,0,0,2,0,0,0,0,0,0,0,13,0,0,13,13
2126,Puducherry,2001,07. Importation of Girls,0,0,0,0,0,0,0,0,0,0,0,0,0,0,0,0,0,0,0,0,0,0,0,0,0,0,0,0,0,0
2127,Punjab,2001,07. Importation of Girls,0,0,0,0,0,0,0,0,0,0,0,0,0,0,0,0,0,0,0,0,0,0,0,0,0,0,0,0,0,0
2128,Rajasthan,2001,07. Importation of Girls,0,0,1,0,0,0,1,0,0,0,1,0,1,1,0,0,0,1,0,0,2,2,0,0,0,2,0,0,0,2
2129,Sikkim,2001,07. Importation of Girls,0,0,0,0,0,0,0,0,0,0,0,0,0,0,0,0,0,0,0,0,0,0,0,0,0,0,0,0,0,0
2130,Tamil Nadu,2001,07. Importation of Girls,5,2,9,5,0,0,11,0,3,0,3,4,14,9,5,0,0,13,4,0,12,12,2,0,0,6,0,6,0,12
2131,Tripura,2001,07. Importation of Girls,0,0,0,0,0,0,0,0,0,0,0,0,0,0,0,0,0,0,0,0,0,0,0,0,0,0,0,0,0,0
2132,Uttar Pradesh,2001,07. Importation of Girls,0,0,0,0,0,0,0,0,0,0,0,0,0,0,0,0,0,0,0,0,0,0,0,0,0,0,0,0,0,0
2133,Uttarakhand,2001,07. Importation of Girls,7,0,0,0,2,0,0,0,0,0,0,9,0,0,9,0,0,9,0,0,0,0,5,0,0,10,0,5,15,15
2134,West Bengal,2001,07. Importation of Girls,0,0,1,0,0,0,1,0,2,0,3,2,3,1,0,0,0,3,0,0,2,1,0,0,1,6,0,0,5,6
2135,Andaman & Nicobar Islands,2002,07. Importation of Girls,0,0,0,0,0,0,0,0,0,0,0,0,0,0,0,0,0,0,0,0,0,0,0,0,0,0,0,0,0,0
2136,Andhra Pradesh,2002,07. Importation of Girls,0,0,1,0,0,0,1,0,0,1,3,2,0,1,0,0,0,3,0,0,0,0,0,2,0,4,2,0,4,4
2137,Arunachal Pradesh,2002,07. Importation of Girls,0,0,0,0,0,0,0,0,0,0,0,0,0,0,0,0,0,0,0,0,0,0,0,0,0,0,0,0,0,0
2138,Assam,2002,07. Importation of Girls,0,0,0,0,0,0,0,0,0,0,0,0,0,0,0,0,0,0,0,0,0,0,0,0,0,0,0,0,0,0
2139,Bihar,2002,07. Importation of Girls,5,6,30,0,0,1,36,0,48,47,85,60,38,30,5,0,0,90,18,0,63,96,0,97,45,225,19,18,147,243
2140,Chandigarh,2002,07. Importation of Girls,0,0,0,0,0,0,0,0,0,0,0,0,0,0,0,0,0,0,0,0,0,0,0,0,0,0,0,0,0,0
2141,Chhattisgarh,2002,07. Importation of Girls,0,0,0,0,0,0,0,0,0,0,0,0,0,0,0,0,0,0,0,0,0,0,0,0,0,0,0,0,0,0
2142,Dadra & Nagar Haveli,2002,07. Importation of Girls,0,0,0,0,0,0,0,0,0,0,0,0,0,0,0,0,0,0,0,0,0,0,0,0,0,0,0,0,0,0
2143,Daman & Diu,2002,07. Importation of Girls,0,0,0,0,0,0,0,0,0,0,0,0,0,0,0,0,0,0,0,0,0,0,0,0,0,0,0,0,0,0
2144,Delhi,2002,07. Importation of Girls,0,0,0,0,0,0,0,0,0,0,0,0,0,0,0,0,0,0,0,0,0,0,0,0,0,0,0,0,0,0
2145,Goa,2002,07. Importation of Girls,0,0,0,0,0,0,0,0,0,0,0,0,0,0,0,0,0,0,0,0,0,0,0,0,0,0,0,0,0,0
2146,Gujarat,2002,07. Importation of Girls,0,0,0,0,0,0,0,0,0,0,0,0,0,0,0,0,0,0,0,0,0,0,0,0,0,0,0,0,0,0
2147,Haryana,2002,07. Importation of Girls,0,0,0,0,0,0,0,0,0,0,0,0,0,0,0,0,0,0,0,0,0,0,0,0,0,0,0,0,0,0
2148,Himachal Pradesh,2002,07. Importation of Girls,0,0,0,0,0,0,0,0,0,0,0,0,0,0,0,0,0,0,0,0,0,0,0,0,0,0,0,0,0,0
2149,Jammu & Kashmir,2002,07. Importation of Girls,0,0,0,0,0,0,0,0,0,0,0,0,0,0,0,0,0,0,0,0,0,0,0,0,0,0,0,0,0,0
2150,Jharkhand,2002,07. Importation of Girls,23,6,29,0,7,0,35,0,1,0,8,9,36,29,30,0,0,38,16,0,33,29,12,2,6,16,0,28,15,44
2151,Karnataka,2002,07. Importation of Girls,0,0,0,0,0,0,0,0,0,0,0,0,0,0,0,0,0,0,0,0,0,0,0,0,0,0,0,0,0,0
2152,Kerala,2002,07. Importation of Girls,0,0,0,0,0,0,0,0,0,0,0,0,0,0,0,0,0,0,0,0,0,0,0,0,0,0,0,0,0,0
2153,Lakshadweep,2002,07. Importation of Girls,0,0,0,0,0,0,0,0,0,0,0,0,0,0,0,0,0,0,0,0,0,0,0,0,0,0,0,0,0,0
2154,Madhya Pradesh,2002,07. Importation of Girls,0,0,0,0,0,0,0,0,0,0,0,0,0,0,0,0,0,0,0,0,0,0,0,0,0,0,0,0,0,0
2155,Maharashtra,2002,07. Importation of Girls,1,0,0,0,0,0,0,0,0,0,0,1,0,0,1,0,0,1,11,0,0,0,0,0,0,0,0,11,11,11
2156,Manipur,2002,07. Importation of Girls,0,0,0,0,0,0,0,0,0,0,0,0,0,0,0,0,0,0,0,0,0,0,0,0,0,0,0,0,0,0
2157,Meghalaya,2002,07. Importation of Girls,0,0,0,0,0,0,0,0,0,0,0,0,0,0,0,0,0,0,0,0,0,0,0,0,0,0,0,0,0,0
2158,Mizoram,2002,07. Importation of Girls,0,0,0,0,0,0,0,0,0,0,0,0,0,0,0,0,0,0,0,0,1,1,1,0,0,0,0,1,0,1
2159,Nagaland,2002,07. Importation of Girls,0,0,0,0,0,0,0,0,0,0,0,0,0,0,0,0,0,0,0,0,0,0,0,0,0,0,0,0,0,0
2160,Odisha,2002,07. Importation of Girls,0,0,0,0,0,0,0,0,0,0,2,2,0,0,0,0,0,2,0,0,0,0,0,0,0,13,0,0,13,13
2161,Puducherry,2002,07. Importation of Girls,0,0,0,0,0,0,0,0,0,0,0,0,0,0,0,0,0,0,0,0,0,0,0,0,0,0,0,0,0,0
2162,Punjab,2002,07. Importation of Girls,0,0,0,0,0,0,0,0,0,0,0,0,0,0,0,0,0,0,0,0,0,0,0,0,0,0,0,0,0,0
2163,Rajasthan,2002,07. Importation of Girls,1,0,0,0,0,0,0,0,0,0,0,1,0,0,1,0,0,1,2,0,0,0,0,0,0,0,0,2,2,2
2164,Sikkim,2002,07. Importation of Girls,0,0,0,0,0,0,0,0,0,0,0,0,0,0,0,0,0,0,0,0,0,0,0,0,0,0,0,0,0,0
2165,Tamil Nadu,2002,07. Importation of Girls,3,2,1,0,1,0,3,0,0,3,0,3,0,1,4,0,0,4,6,0,0,0,0,0,0,0,0,6,6,6
2166,Tripura,2002,07. Importation of Girls,0,0,0,0,0,0,0,0,0,0,0,0,0,0,0,0,0,0,0,0,0,0,0,0,0,0,0,0,0,0
2167,Uttar Pradesh,2002,07. Importation of Girls,0,0,0,0,0,0,0,0,0,0,0,0,0,0,0,0,0,0,0,0,0,0,0,0,0,0,0,0,0,0
2168,Uttarakhand,2002,07. Importation of Girls,0,0,1,0,1,0,1,0,0,0,0,0,1,1,1,0,0,1,7,0,2,2,5,0,0,0,0,12,10,12
2169,West Bengal,2002,07. Importation of Girls,0,0,1,0,0,0,1,0,2,2,4,3,1,1,0,0,0,4,0,0,2,1,0,1,2,7,0,0,6,7
2170,Andaman & Nicobar Islands,2003,07. Importation of Girls,0,0,0,0,0,0,0,0,0,0,0,0,0,0,0,0,0,0,0,0,0,0,0,0,0,0,0,0,0,0
2171,Andhra Pradesh,2003,07. Importation of Girls,2,0,5,0,1,0,5,0,0,0,5,3,5,5,3,0,0,8,2,0,1,1,2,0,0,1,0,4,4,5
2172,Arunachal Pradesh,2003,07. Importation of Girls,0,0,0,0,0,0,0,0,0,0,0,0,0,0,0,0,0,0,0,0,0,0,0,0,0,0,0,0,0,0
2173,Assam,2003,07. Importation of Girls,0,0,0,0,0,0,0,0,0,0,0,0,0,0,0,0,0,0,0,0,0,0,0,0,0,0,0,0,0,0
2174,Bihar,2003,07. Importation of Girls,6,4,38,0,0,3,42,0,40,48,117,85,37,38,6,0,0,123,14,0,48,65,0,45,23,276,5,14,225,290
2175,Chandigarh,2003,07. Importation of Girls,0,0,0,0,0,0,0,0,0,0,0,0,0,0,0,0,0,0,0,0,0,0,0,0,0,0,0,0,0,0
2176,Chhattisgarh,2003,07. Importation of Girls,0,0,0,0,0,0,0,0,0,0,0,0,0,0,0,0,0,0,0,0,0,0,0,0,0,0,0,0,0,0
2177,Dadra & Nagar Haveli,2003,07. Importation of Girls,0,0,0,0,0,0,0,0,0,0,0,0,0,0,0,0,0,0,0,0,0,0,0,0,0,0,0,0,0,0
2178,Daman & Diu,2003,07. Importation of Girls,0,0,0,0,0,0,0,0,0,0,0,0,0,0,0,0,0,0,0,0,0,0,0,0,0,0,0,0,0,0
2179,Delhi,2003,07. Importation of Girls,0,0,0,0,0,0,0,0,0,0,0,0,0,0,0,0,0,0,0,0,0,0,0,0,0,0,0,0,0,0
2180,Goa,2003,07. Importation of Girls,0,0,0,0,0,0,0,0,0,0,0,0,0,0,0,0,0,0,0,0,0,0,0,0,0,0,0,0,0,0
2181,Gujarat,2003,07. Importation of Girls,0,0,0,0,0,0,0,0,0,0,0,0,0,0,0,0,0,0,0,0,0,0,0,0,0,0,0,0,0,0
2182,Haryana,2003,07. Importation of Girls,0,0,0,0,0,0,0,0,0,0,0,0,0,0,0,0,0,0,0,0,0,0,0,0,0,0,0,0,0,0
2183,Himachal Pradesh,2003,07. Importation of Girls,0,0,0,0,0,0,0,0,0,0,0,0,0,0,0,0,0,0,0,0,0,0,0,0,0,0,0,0,0,0
2184,Jammu & Kashmir,2003,07. Importation of Girls,0,0,0,0,0,0,0,0,0,0,0,0,0,0,0,0,0,0,0,0,0,0,0,0,0,0,0,0,0,0
2185,Jharkhand,2003,07. Importation of Girls,0,0,0,0,0,0,0,0,1,1,8,8,0,0,0,0,0,8,22,0,0,6,0,6,0,0,0,22,16,22
2186,Karnataka,2003,07. Importation of Girls,0,0,0,0,0,0,0,0,0,0,0,0,0,0,0,0,0,0,0,0,0,0,0,0,0,0,0,0,0,0
2187,Kerala,2003,07. Importation of Girls,0,0,0,0,0,0,0,0,0,0,0,0,0,0,0,0,0,0,0,0,0,0,0,0,0,0,0,0,0,0
2188,Lakshadweep,2003,07. Importation of Girls,0,0,0,0,0,0,0,0,0,0,0,0,0,0,0,0,0,0,0,0,0,0,0,0,0,0,0,0,0,0
2189,Madhya Pradesh,2003,07. Importation of Girls,0,0,0,0,0,0,0,0,0,0,0,0,0,0,0,0,0,0,0,0,0,0,0,0,0,0,0,0,0,0
2190,Maharashtra,2003,07. Importation of Girls,0,0,0,0,0,0,0,0,0,0,0,0,0,0,0,0,0,0,0,0,0,0,0,0,0,0,0,0,0,0
2191,Manipur,2003,07. Importation of Girls,0,0,0,0,0,0,0,0,0,0,0,0,0,0,0,0,0,0,0,0,0,0,0,0,0,0,0,0,0,0
2192,Meghalaya,2003,07. Importation of Girls,0,0,0,0,0,0,0,0,0,0,0,0,0,0,0,0,0,0,0,0,0,0,0,0,0,0,0,0,0,0
2193,Mizoram,2003,07. Importation of Girls,0,0,0,0,0,0,0,0,0,0,0,0,0,0,0,0,0,0,0,0,1,1,1,0,0,0,0,1,0,1
2194,Nagaland,2003,07. Importation of Girls,0,0,0,0,0,0,0,0,1,0,0,0,1,0,0,0,0,0,0,0,1,0,0,0,1,0,0,0,0,0
2195,Odisha,2003,07. Importation of Girls,0,0,0,0,0,0,0,0,0,0,2,2,0,0,0,0,0,2,0,0,0,0,0,0,0,13,0,0,13,13
2196,Puducherry,2003,07. Importation of Girls,0,0,0,0,0,0,0,0,0,0,0,0,0,0,0,0,0,0,0,0,0,0,0,0,0,0,0,0,0,0
2197,Punjab,2003,07. Importation of Girls,0,0,0,0,0,0,0,0,0,0,0,0,0,0,0,0,0,0,0,0,0,0,0,0,0,0,0,0,0,0
2198,Rajasthan,2003,07. Importation of Girls,0,0,1,0,0,0,1,0,0,0,1,0,1,1,0,0,0,1,0,0,3,3,0,0,0,3,0,0,0,3
2199,Sikkim,2003,07. Importation of Girls,0,0,0,0,0,0,0,0,0,0,0,0,0,0,0,0,0,0,0,0,0,0,0,0,0,0,0,0,0,0
2200,Tamil Nadu,2003,07. Importation of Girls,0,0,0,0,0,0,0,0,1,0,0,0,1,0,0,0,0,0,0,0,0,0,0,0,0,0,0,0,0,0
2201,Tripura,2003,07. Importation of Girls,0,0,0,0,0,0,0,0,0,0,0,0,0,0,0,0,0,0,0,0,0,0,0,0,0,0,0,0,0,0
2202,Uttar Pradesh,2003,07. Importation of Girls,0,0,0,0,0,0,0,0,0,0,0,0,0,0,0,0,0,0,0,0,0,0,0,0,0,0,0,0,0,0
2203,Uttarakhand,2003,07. Importation of Girls,0,0,0,0,0,0,0,0,0,0,0,0,0,0,0,0,0,0,0,0,0,0,0,0,0,0,0,0,0,0
2204,West Bengal,2003,07. Importation of Girls,0,0,0,0,0,0,0,0,3,2,4,4,1,0,0,0,0,4,0,0,1,0,0,2,3,7,0,0,7,7
2205,Andaman & Nicobar Islands,2004,07. Importation of Girls,0,0,0,0,0,0,0,0,0,0,0,0,0,0,0,0,0,0,0,0,0,0,0,0,0,0,0,0,0,0
2206,Andhra Pradesh,2004,07. Importation of Girls,5,0,2,0,0,0,2,0,0,0,2,5,2,2,5,0,0,7,1,0,5,5,0,0,0,5,0,1,1,6
2207,Arunachal Pradesh,2004,07. Importation of Girls,0,0,0,0,0,0,0,0,0,0,0,0,0,0,0,0,0,0,0,0,0,0,0,0,0,0,0,0,0,0
2208,Assam,2004,07. Importation of Girls,0,0,0,0,0,0,0,0,0,0,0,0,0,0,0,0,0,0,0,0,0,0,0,0,0,0,0,0,0,0
2209,Bihar,2004,07. Importation of Girls,6,2,33,0,0,4,35,0,36,40,144,117,35,33,6,0,0,150,8,0,39,39,0,23,23,307,0,8,276,315
2210,Chandigarh,2004,07. Importation of Girls,0,0,0,0,0,0,0,0,0,0,0,0,0,0,0,0,0,0,0,0,0,0,0,0,0,0,0,0,0,0
2211,Chhattisgarh,2004,07. Importation of Girls,0,0,0,0,0,0,0,0,0,0,0,0,0,0,0,0,0,0,0,0,0,0,0,0,0,0,0,0,0,0
2212,Dadra & Nagar Haveli,2004,07. Importation of Girls,0,0,0,0,0,0,0,0,0,0,0,0,0,0,0,0,0,0,0,0,0,0,0,0,0,0,0,0,0,0
2213,Daman & Diu,2004,07. Importation of Girls,0,0,0,0,0,0,0,0,0,0,0,0,0,0,0,0,0,0,0,0,0,0,0,0,0,0,0,0,0,0
2214,Delhi,2004,07. Importation of Girls,0,0,0,0,0,0,0,0,0,0,0,0,0,0,0,0,0,0,0,0,0,0,0,0,0,0,0,0,0,0
2215,Goa,2004,07. Importation of Girls,0,0,0,0,0,0,0,0,0,0,0,0,0,0,0,0,0,0,0,0,0,0,0,0,0,0,0,0,0,0
2216,Gujarat,2004,07. Importation of Girls,0,0,0,0,0,0,0,0,0,0,0,0,0,0,0,0,0,0,0,0,0,0,0,0,0,0,0,0,0,0
2217,Haryana,2004,07. Importation of Girls,0,0,0,0,0,0,0,0,0,0,0,0,0,0,0,0,0,0,0,0,0,0,0,0,0,0,0,0,0,0
2218,Himachal Pradesh,2004,07. Importation of Girls,0,0,0,0,0,0,0,0,0,0,0,0,0,0,0,0,0,0,0,0,0,0,0,0,0,0,0,0,0,0
2219,Jammu & Kashmir,2004,07. Importation of Girls,0,0,0,0,0,0,0,0,0,0,0,0,0,0,0,0,0,0,0,0,0,0,0,0,0,0,0,0,0,0
2220,Jharkhand,2004,07. Importation of Girls,0,0,0,0,0,0,0,0,37,1,8,8,36,0,0,0,0,8,0,0,0,0,0,0,0,0,0,0,0,0
2221,Karnataka,2004,07. Importation of Girls,0,0,0,0,0,0,0,0,0,0,0,0,0,0,0,0,0,0,0,0,0,0,0,0,0,0,0,0,0,0
2222,Kerala,2004,07. Importation of Girls,0,0,0,0,0,0,0,0,0,0,0,0,0,0,0,0,0,0,0,0,0,0,0,0,0,0,0,0,0,0
2223,Lakshadweep,2004,07. Importation of Girls,0,0,0,0,0,0,0,0,0,0,0,0,0,0,0,0,0,0,0,0,0,0,0,0,0,0,0,0,0,0
2224,Madhya Pradesh,2004,07. Importation of Girls,0,0,0,0,0,0,0,0,0,0,0,0,0,0,0,0,0,0,0,0,0,0,0,0,0,0,0,0,0,0
2225,Maharashtra,2004,07. Importation of Girls,0,0,0,0,0,0,0,0,0,0,0,0,0,0,0,0,0,0,0,0,0,0,0,0,0,0,0,0,0,0
2226,Manipur,2004,07. Importation of Girls,0,0,0,0,0,0,0,0,0,0,0,0,0,0,0,0,0,0,0,0,0,0,0,0,0,0,0,0,0,0
2227,Meghalaya,2004,07. Importation of Girls,0,0,0,0,0,0,0,0,0,0,0,0,0,0,0,0,0,0,0,0,0,0,0,0,0,0,0,0,0,0
2228,Mizoram,2004,07. Importation of Girls,0,0,0,0,0,0,0,0,0,0,0,0,0,0,0,0,0,0,0,0,0,0,0,0,0,0,0,0,0,0
2229,Nagaland,2004,07. Importation of Girls,0,0,1,0,1,0,1,0,0,1,0,0,0,1,1,0,0,1,0,0,0,1,1,1,0,0,0,1,0,1
2230,Odisha,2004,07. Importation of Girls,2,0,0,0,0,0,0,0,0,0,0,2,0,0,2,0,0,2,13,0,0,0,0,0,0,0,0,13,13,13
2231,Puducherry,2004,07. Importation of Girls,0,0,0,0,0,0,0,0,0,0,0,0,0,0,0,0,0,0,0,0,0,0,0,0,0,0,0,0,0,0
2232,Punjab,2004,07. Importation of Girls,0,0,0,0,0,0,0,0,0,0,0,0,0,0,0,0,0,0,0,0,0,0,0,0,0,0,0,0,0,0
2233,Rajasthan,2004,07. Importation of Girls,1,0,1,0,0,0,1,0,0,0,1,1,1,1,1,0,0,2,5,0,5,5,0,0,0,3,0,5,3,8
2234,Sikkim,2004,07. Importation of Girls,0,0,0,0,0,0,0,0,0,0,0,0,0,0,0,0,0,0,0,0,0,0,0,0,0,0,0,0,0,0
2235,Tamil Nadu,2004,07. Importation of Girls,0,0,0,0,0,1,0,0,0,1,0,0,0,0,0,0,0,0,0,0,0,0,0,0,0,0,0,0,0,0
2236,Tripura,2004,07. Importation of Girls,0,0,0,0,0,0,0,0,0,0,0,0,0,0,0,0,0,0,0,0,0,0,0,0,0,0,0,0,0,0
2237,Uttar Pradesh,2004,07. Importation of Girls,0,1,2,0,0,0,3,0,0,0,2,0,3,2,0,0,0,2,0,7,7,7,0,0,0,0,0,0,0,7
2238,Uttarakhand,2004,07. Importation of Girls,0,0,0,0,0,0,0,0,0,0,0,0,0,0,0,0,0,0,0,0,0,0,0,0,0,0,0,0,0,0
2239,West Bengal,2004,07. Importation of Girls,1,0,1,0,0,0,1,0,14,3,4,4,12,1,1,0,0,5,2,0,12,2,0,3,13,7,0,2,7,9
2240,Andaman & Nicobar Islands,2005,07. Importation of Girls,0,0,0,0,0,0,0,0,0,0,0,0,0,0,0,0,0,0,0,0,0,0,0,0,0,0,0,0,0,0
2241,Andhra Pradesh,2005,07. Importation of Girls,1,0,2,0,0,0,2,0,1,0,3,2,3,2,1,0,0,4,3,0,5,5,0,0,0,7,0,3,5,10
2242,Arunachal Pradesh,2005,07. Importation of Girls,0,0,0,0,0,0,0,0,0,0,0,0,0,0,0,0,0,0,0,0,0,0,0,0,0,0,0,0,0,0
2243,Assam,2005,07. Importation of Girls,0,0,3,0,0,0,3,0,0,0,3,0,3,3,0,0,0,3,0,0,3,3,0,0,0,3,0,0,0,3
2244,Bihar,2005,07. Importation of Girls,10,4,42,0,7,5,46,0,59,36,169,144,74,42,17,0,0,186,14,0,90,62,9,23,48,346,3,23,307,369
2245,Chandigarh,2005,07. Importation of Girls,0,0,0,0,0,0,0,0,0,0,0,0,0,0,0,0,0,0,0,0,0,0,0,0,0,0,0,0,0,0
2246,Chhattisgarh,2005,07. Importation of Girls,0,0,0,0,0,0,0,0,0,0,0,0,0,0,0,0,0,0,0,0,0,0,0,0,0,0,0,0,0,0
2247,Dadra & Nagar Haveli,2005,07. Importation of Girls,0,0,0,0,0,0,0,0,0,0,0,0,0,0,0,0,0,0,0,0,0,0,0,0,0,0,0,0,0,0
2248,Daman & Diu,2005,07. Importation of Girls,0,0,0,0,0,0,0,0,0,0,0,0,0,0,0,0,0,0,0,0,0,0,0,0,0,0,0,0,0,0
2249,Delhi,2005,07. Importation of Girls,0,0,0,0,0,0,0,0,1,0,0,0,1,0,0,0,0,0,0,0,0,0,0,0,0,0,0,0,0,0
2250,Goa,2005,07. Importation of Girls,0,0,0,0,0,0,0,0,0,0,0,0,0,0,0,0,0,0,0,0,0,0,0,0,0,0,0,0,0,0
2251,Gujarat,2005,07. Importation of Girls,0,0,0,0,0,0,0,0,0,0,0,0,0,0,0,0,0,0,0,0,0,0,0,0,0,0,0,0,0,0
2252,Haryana,2005,07. Importation of Girls,0,0,0,0,0,0,0,0,0,0,0,0,0,0,0,0,0,0,0,0,0,0,0,0,0,0,0,0,0,0
2253,Himachal Pradesh,2005,07. Importation of Girls,0,0,0,0,0,0,0,0,0,0,0,0,0,0,0,0,0,0,0,0,0,0,0,0,0,0,0,0,0,0
2254,Jammu & Kashmir,2005,07. Importation of Girls,0,0,0,0,0,0,0,0,0,0,0,0,0,0,0,0,0,0,0,0,0,0,0,0,0,0,0,0,0,0
2255,Jharkhand,2005,07. Importation of Girls,3,3,1,0,0,0,4,0,37,37,6,8,4,1,3,0,0,9,0,0,35,11,0,0,15,11,9,0,0,11
2256,Karnataka,2005,07. Importation of Girls,0,0,0,0,0,0,0,0,0,0,0,0,0,0,0,0,0,0,0,0,0,0,0,0,0,0,0,0,0,0
2257,Kerala,2005,07. Importation of Girls,0,0,0,0,0,0,0,0,0,0,0,0,0,0,0,0,0,0,0,0,0,0,0,0,0,0,0,0,0,0
2258,Lakshadweep,2005,07. Importation of Girls,0,0,0,0,0,0,0,0,0,0,0,0,0,0,0,0,0,0,0,0,0,0,0,0,0,0,0,0,0,0
2259,Madhya Pradesh,2005,07. Importation of Girls,0,0,3,0,0,0,3,0,0,0,3,0,3,3,0,0,0,3,0,0,4,4,0,0,0,4,0,0,0,4
2260,Maharashtra,2005,07. Importation of Girls,0,0,0,0,0,0,0,0,0,0,0,0,0,0,0,0,0,0,0,0,0,0,0,0,0,0,0,0,0,0
2261,Manipur,2005,07. Importation of Girls,0,0,0,0,0,0,0,0,0,0,0,0,0,0,0,0,0,0,0,0,0,0,0,0,0,0,0,0,0,0
2262,Meghalaya,2005,07. Importation of Girls,0,0,0,0,0,0,0,0,0,0,0,0,0,0,0,0,0,0,0,0,0,0,0,0,0,0,0,0,0,0
2263,Mizoram,2005,07. Importation of Girls,0,0,0,0,0,0,0,0,0,0,0,0,0,0,0,0,0,0,0,0,0,0,0,0,0,0,0,0,0,0
2264,Nagaland,2005,07. Importation of Girls,0,0,0,0,0,0,0,0,0,0,0,0,0,0,0,0,0,0,0,0,0,0,0,0,0,0,0,0,0,0
2265,Odisha,2005,07. Importation of Girls,0,0,0,0,0,0,0,0,0,0,0,0,0,0,0,0,0,0,0,0,0,0,0,0,0,0,0,0,0,0
2266,Puducherry,2005,07. Importation of Girls,0,0,0,0,0,0,0,0,0,0,0,0,0,0,0,0,0,0,0,0,0,0,0,0,0,0,0,0,0,0
2267,Punjab,2005,07. Importation of Girls,0,0,0,0,0,0,0,0,0,0,0,0,0,0,0,0,0,0,0,0,0,0,0,0,0,0,0,0,0,0
2268,Rajasthan,2005,07. Importation of Girls,0,0,0,0,1,0,0,0,0,0,0,1,0,0,1,0,0,1,0,0,0,0,3,0,0,0,0,3,3,3
2269,Sikkim,2005,07. Importation of Girls,0,0,0,0,0,0,0,0,0,0,0,0,0,0,0,0,0,0,0,0,0,0,0,0,0,0,0,0,0,0
2270,Tamil Nadu,2005,07. Importation of Girls,0,0,0,0,0,0,0,0,0,0,0,0,0,0,0,0,0,0,0,0,0,0,0,0,0,0,0,0,0,0
2271,Tripura,2005,07. Importation of Girls,0,0,0,0,0,0,0,0,0,0,0,0,0,0,0,0,0,0,0,0,0,0,0,0,0,0,0,0,0,0
2272,Uttar Pradesh,2005,07. Importation of Girls,0,0,0,2,0,0,0,0,0,0,0,2,0,0,0,0,0,2,0,0,0,0,0,0,0,0,0,0,0,0
2273,Uttarakhand,2005,07. Importation of Girls,0,0,0,0,0,0,0,0,0,0,0,0,0,0,0,0,0,0,0,0,0,0,0,0,0,0,0,0,0,0
2274,West Bengal,2005,07. Importation of Girls,1,1,2,0,0,0,3,0,72,14,5,4,61,2,1,0,0,6,2,0,75,5,0,13,83,10,0,2,7,12
2275,Andaman & Nicobar Islands,2006,07. Importation of Girls,0,0,0,0,0,0,0,0,0,0,0,0,0,0,0,0,0,0,0,0,0,0,0,0,0,0,0,0,0,0
2276,Andhra Pradesh,2006,07. Importation of Girls,2,1,0,0,0,0,1,0,0,1,1,3,0,0,2,0,0,3,5,0,0,0,0,0,0,2,0,5,7,7
2277,Arunachal Pradesh,2006,07. Importation of Girls,0,0,0,0,0,0,0,0,0,0,0,0,0,0,0,0,0,0,0,0,0,0,0,0,0,0,0,0,0,0
2278,Assam,2006,07. Importation of Girls,0,0,0,0,0,0,0,0,0,0,3,3,0,0,0,0,0,3,0,0,0,0,0,0,0,3,0,0,3,3
2279,Bihar,2006,07. Importation of Girls,16,1,36,0,8,5,37,0,59,59,181,169,42,36,24,0,0,205,20,0,68,60,13,48,56,373,0,33,346,406
2280,Chandigarh,2006,07. Importation of Girls,0,0,0,0,0,0,0,0,0,0,0,0,0,0,0,0,0,0,0,0,0,0,0,0,0,0,0,0,0,0
2281,Chhattisgarh,2006,07. Importation of Girls,0,0,1,0,0,0,1,0,0,0,1,0,1,1,0,0,0,1,0,0,3,3,0,0,0,3,0,0,0,3
2282,Dadra & Nagar Haveli,2006,07. Importation of Girls,0,0,0,0,0,0,0,0,0,0,0,0,0,0,0,0,0,0,0,0,0,0,0,0,0,0,0,0,0,0
2283,Daman & Diu,2006,07. Importation of Girls,0,0,0,0,0,0,0,0,0,0,0,0,0,0,0,0,0,0,0,0,0,0,0,0,0,0,0,0,0,0
2284,Delhi,2006,07. Importation of Girls,0,0,0,0,0,0,0,0,1,1,0,0,0,0,0,0,0,0,0,0,0,0,0,0,0,0,0,0,0,0
2285,Goa,2006,07. Importation of Girls,0,0,0,0,0,0,0,0,0,0,0,0,0,0,0,0,0,0,0,0,0,0,0,0,0,0,0,0,0,0
2286,Gujarat,2006,07. Importation of Girls,0,0,0,0,0,0,0,0,0,0,0,0,0,0,0,0,0,0,0,0,0,0,0,0,0,0,0,0,0,0
2287,Haryana,2006,07. Importation of Girls,0,0,0,0,0,0,0,0,0,0,0,0,0,0,0,0,0,0,0,0,0,0,0,0,0,0,0,0,0,0
2288,Himachal Pradesh,2006,07. Importation of Girls,0,0,0,0,0,0,0,0,0,0,0,0,0,0,0,0,0,0,0,0,0,0,0,0,0,0,0,0,0,0
2289,Jammu & Kashmir,2006,07. Importation of Girls,0,0,0,0,0,0,0,0,0,0,0,0,0,0,0,0,0,0,0,0,0,0,0,0,0,0,0,0,0,0
2290,Jharkhand,2006,07. Importation of Girls,0,0,2,0,0,0,2,0,40,37,8,6,5,2,0,0,0,8,25,0,0,15,0,15,0,1,0,25,11,26
2291,Karnataka,2006,07. Importation of Girls,0,0,0,0,0,0,0,0,0,0,0,0,0,0,0,0,0,0,0,0,0,0,0,0,0,0,0,0,0,0
2292,Kerala,2006,07. Importation of Girls,0,0,0,0,0,0,0,0,0,0,0,0,0,0,0,0,0,0,0,0,0,0,0,0,0,0,0,0,0,0
2293,Lakshadweep,2006,07. Importation of Girls,0,0,0,0,0,0,0,0,0,0,0,0,0,0,0,0,0,0,0,0,0,0,0,0,0,0,0,0,0,0
2294,Madhya Pradesh,2006,07. Importation of Girls,0,0,0,0,1,0,0,0,0,0,2,3,0,0,1,0,0,3,0,0,0,0,0,0,0,4,0,0,4,4
2295,Maharashtra,2006,07. Importation of Girls,0,0,1,0,0,0,1,0,0,0,1,0,1,1,0,0,0,1,0,0,2,2,0,0,0,2,0,0,0,2
2296,Manipur,2006,07. Importation of Girls,0,0,0,0,0,0,0,0,0,0,0,0,0,0,0,0,0,0,0,0,0,0,0,0,0,0,0,0,0,0
2297,Meghalaya,2006,07. Importation of Girls,0,0,0,0,0,0,0,0,0,0,0,0,0,0,0,0,0,0,0,0,0,0,0,0,0,0,0,0,0,0
2298,Mizoram,2006,07. Importation of Girls,0,0,0,0,0,0,0,0,0,0,0,0,0,0,0,0,0,0,0,0,0,0,0,0,0,0,0,0,0,0
2299,Nagaland,2006,07. Importation of Girls,0,0,0,0,0,0,0,0,0,0,0,0,0,0,0,0,0,0,0,0,0,0,0,0,0,0,0,0,0,0
2300,Odisha,2006,07. Importation of Girls,0,0,0,0,0,0,0,0,12,0,0,0,12,0,0,0,0,0,0,0,0,0,0,0,0,0,0,0,0,0
2301,Puducherry,2006,07. Importation of Girls,0,0,0,0,0,0,0,0,0,0,0,0,0,0,0,0,0,0,0,0,0,0,0,0,0,0,0,0,0,0
2302,Punjab,2006,07. Importation of Girls,0,0,0,0,0,0,0,0,2,0,0,0,2,0,0,0,0,0,0,0,6,0,0,0,6,0,0,0,0,0
2303,Rajasthan,2006,07. Importation of Girls,1,0,3,0,0,0,3,0,0,0,2,0,3,3,1,0,0,3,2,0,4,4,0,0,0,2,0,2,0,4
2304,Sikkim,2006,07. Importation of Girls,0,0,0,0,0,0,0,0,0,0,0,0,0,0,0,0,0,0,0,0,0,0,0,0,0,0,0,0,0,0
2305,Tamil Nadu,2006,07. Importation of Girls,0,0,0,0,0,0,0,0,0,0,0,0,0,0,0,0,0,0,0,0,0,0,0,0,0,0,0,0,0,0
2306,Tripura,2006,07. Importation of Girls,0,0,0,0,0,0,0,0,0,0,0,0,0,0,0,0,0,0,0,0,0,0,0,0,0,0,0,0,0,0
2307,Uttar Pradesh,2006,07. Importation of Girls,0,0,0,0,0,0,0,0,0,0,0,0,0,0,0,0,0,0,0,0,0,0,0,0,0,0,0,0,0,0
2308,Uttarakhand,2006,07. Importation of Girls,0,0,0,0,0,0,0,0,0,0,0,0,0,0,0,0,0,0,0,0,0,0,0,0,0,0,0,0,0,0
2309,West Bengal,2006,07. Importation of Girls,1,19,11,0,1,0,30,0,43,72,14,5,1,11,2,0,0,16,3,0,2,23,1,83,61,29,1,4,10,33
2310,Andaman & Nicobar Islands,2007,07. Importation of Girls,0,0,0,0,0,0,0,0,0,0,0,0,0,0,0,0,0,0,0,0,0,0,0,0,0,0,0,0,0,0
2311,Andhra Pradesh,2007,07. Importation of Girls,0,0,0,0,0,0,0,0,0,0,1,1,0,0,0,0,0,1,0,0,0,0,0,0,0,2,0,0,2,2
2312,Arunachal Pradesh,2007,07. Importation of Girls,0,0,0,0,0,0,0,0,0,0,0,0,0,0,0,0,0,0,0,0,0,0,0,0,0,0,0,0,0,0
2313,Assam,2007,07. Importation of Girls,0,0,0,0,0,0,0,0,0,0,3,3,0,0,0,0,0,3,0,0,0,0,0,0,0,3,0,0,3,3
2314,Bihar,2007,07. Importation of Girls,31,2,53,0,5,10,55,0,50,59,198,181,56,53,36,0,0,234,43,0,87,83,10,56,58,403,2,53,373,456
2315,Chandigarh,2007,07. Importation of Girls,0,0,0,0,0,0,0,0,0,0,0,0,0,0,0,0,0,0,0,0,0,0,0,0,0,0,0,0,0,0
2316,Chhattisgarh,2007,07. Importation of Girls,1,0,0,0,0,0,0,0,0,0,0,1,0,0,1,0,0,1,3,0,0,0,0,0,0,0,0,3,3,3
2317,Dadra & Nagar Haveli,2007,07. Importation of Girls,0,0,0,0,0,0,0,0,0,0,0,0,0,0,0,0,0,0,0,0,0,0,0,0,0,0,0,0,0,0
2318,Daman & Diu,2007,07. Importation of Girls,0,0,0,0,0,0,0,0,0,0,0,0,0,0,0,0,0,0,0,0,0,0,0,0,0,0,0,0,0,0
2319,Delhi,2007,07. Importation of Girls,0,0,0,0,0,0,0,0,1,1,0,0,0,0,0,0,0,0,0,0,0,0,0,0,0,0,0,0,0,0
2320,Goa,2007,07. Importation of Girls,0,0,0,0,0,0,0,0,0,0,0,0,0,0,0,0,0,0,0,0,0,0,0,0,0,0,0,0,0,0
2321,Gujarat,2007,07. Importation of Girls,0,0,0,0,0,0,0,0,0,0,0,0,0,0,0,0,0,0,0,0,0,0,0,0,0,0,0,0,0,0
2322,Haryana,2007,07. Importation of Girls,0,0,0,0,0,0,0,0,0,0,0,0,0,0,0,0,0,0,0,0,0,0,0,0,0,0,0,0,0,0
2323,Himachal Pradesh,2007,07. Importation of Girls,0,0,0,0,0,0,0,0,0,0,0,0,0,0,0,0,0,0,0,0,0,0,0,0,0,0,0,0,0,0
2324,Jammu & Kashmir,2007,07. Importation of Girls,0,0,0,0,0,0,0,0,0,0,0,0,0,0,0,0,0,0,0,0,0,0,0,0,0,0,0,0,0,0
2325,Jharkhand,2007,07. Importation of Girls,0,1,0,2,0,23,1,2,14,40,6,8,0,0,0,0,0,8,0,0,0,0,0,0,0,1,0,0,1,1
2326,Karnataka,2007,07. Importation of Girls,0,0,0,0,0,0,0,0,0,0,0,0,0,0,0,0,0,0,0,0,0,0,0,0,0,0,0,0,0,0
2327,Kerala,2007,07. Importation of Girls,0,0,0,0,0,0,0,0,0,0,0,0,0,0,0,0,0,0,0,0,0,0,0,0,0,0,0,0,0,0
2328,Lakshadweep,2007,07. Importation of Girls,0,0,0,0,0,0,0,0,0,0,0,0,0,0,0,0,0,0,0,0,0,0,0,0,0,0,0,0,0,0
2329,Madhya Pradesh,2007,07. Importation of Girls,0,0,0,0,0,0,0,0,0,0,2,2,0,0,0,0,0,2,0,0,0,0,0,0,0,4,0,0,4,4
2330,Maharashtra,2007,07. Importation of Girls,1,0,0,0,0,0,0,0,0,0,0,1,0,0,1,0,0,1,2,0,0,0,0,0,0,0,0,2,2,2
2331,Manipur,2007,07. Importation of Girls,0,0,0,0,0,0,0,0,0,0,0,0,0,0,0,0,0,0,0,0,0,0,0,0,0,0,0,0,0,0
2332,Meghalaya,2007,07. Importation of Girls,0,0,0,0,0,0,0,0,0,0,0,0,0,0,0,0,0,0,0,0,0,0,0,0,0,0,0,0,0,0
2333,Mizoram,2007,07. Importation of Girls,0,0,0,0,0,0,0,0,0,0,0,0,0,0,0,0,0,0,0,0,0,0,0,0,0,0,0,0,0,0
2334,Nagaland,2007,07. Importation of Girls,0,0,0,0,0,0,0,0,0,0,0,0,0,0,0,0,0,0,0,0,0,0,0,0,0,0,0,0,0,0
2335,Odisha,2007,07. Importation of Girls,0,0,12,0,0,0,12,0,0,12,12,0,0,12,0,0,0,12,0,0,0,0,0,0,0,0,0,0,0,0
2336,Puducherry,2007,07. Importation of Girls,0,0,0,0,0,0,0,0,0,0,0,0,0,0,0,0,0,0,0,0,0,0,0,0,0,0,0,0,0,0
2337,Punjab,2007,07. Importation of Girls,0,0,0,0,0,0,0,0,2,2,0,0,0,0,0,0,0,0,0,0,0,0,0,6,6,0,0,0,0,0
2338,Rajasthan,2007,07. Importation of Girls,0,0,0,0,0,0,0,0,0,0,2,2,0,0,0,0,0,2,0,0,0,0,0,0,0,2,0,0,2,2
2339,Sikkim,2007,07. Importation of Girls,0,0,0,0,0,0,0,0,0,0,0,0,0,0,0,0,0,0,0,0,0,0,0,0,0,0,0,0,0,0
2340,Tamil Nadu,2007,07. Importation of Girls,0,0,0,0,0,0,0,0,0,0,0,0,0,0,0,0,0,0,0,0,0,0,0,0,0,0,0,0,0,0
2341,Tripura,2007,07. Importation of Girls,0,0,0,0,0,0,0,0,0,0,0,0,0,0,0,0,0,0,0,0,0,0,0,0,0,0,0,0,0,0
2342,Uttar Pradesh,2007,07. Importation of Girls,0,0,0,0,0,0,0,0,0,0,0,0,0,0,0,0,0,0,0,0,0,0,0,0,0,0,0,0,0,0
2343,Uttarakhand,2007,07. Importation of Girls,0,0,0,0,0,0,0,0,0,0,0,0,0,0,0,0,0,0,0,0,0,0,0,0,0,0,0,0,0,0
2344,West Bengal,2007,07. Importation of Girls,4,4,17,0,0,0,21,0,27,43,27,14,5,17,4,0,0,31,10,0,8,44,0,61,17,63,8,10,29,73
2345,Andaman & Nicobar Islands,2008,07. Importation of Girls,0,0,0,0,0,0,0,0,0,0,0,0,0,0,0,0,0,0,0,0,0,0,0,0,0,0,0,0,0,0
2346,Andhra Pradesh,2008,07. Importation of Girls,0,0,0,0,0,0,0,0,0,0,1,1,0,0,0,0,0,1,0,0,0,0,0,0,0,2,0,0,2,2
2347,Arunachal Pradesh,2008,07. Importation of Girls,0,0,0,0,0,0,0,0,0,0,0,0,0,0,0,0,0,0,0,0,0,0,0,0,0,0,0,0,0,0
2348,Assam,2008,07. Importation of Girls,2,0,0,0,0,0,0,0,0,0,1,3,0,0,2,0,0,3,2,0,0,0,0,0,0,1,0,2,3,3
2349,Bihar,2008,07. Importation of Girls,24,3,39,0,3,0,42,0,30,50,210,198,22,39,27,0,0,237,37,0,56,64,4,58,50,426,0,41,403,467
2350,Chandigarh,2008,07. Importation of Girls,0,0,0,0,0,0,0,0,0,0,0,0,0,0,0,0,0,0,0,0,0,0,0,0,0,0,0,0,0,0
2351,Chhattisgarh,2008,07. Importation of Girls,0,0,0,0,0,0,0,0,0,0,0,0,0,0,0,0,0,0,0,0,0,0,0,0,0,0,0,0,0,0
2352,Dadra & Nagar Haveli,2008,07. Importation of Girls,0,0,0,0,0,0,0,0,0,0,0,0,0,0,0,0,0,0,0,0,0,0,0,0,0,0,0,0,0,0
2353,Daman & Diu,2008,07. Importation of Girls,0,0,0,0,0,0,0,0,0,0,0,0,0,0,0,0,0,0,0,0,0,0,0,0,0,0,0,0,0,0
2354,Delhi,2008,07. Importation of Girls,0,0,0,0,0,0,0,0,1,1,0,0,0,0,0,0,0,0,0,0,0,0,0,0,0,0,0,0,0,0
2355,Goa,2008,07. Importation of Girls,0,0,0,0,0,0,0,0,0,0,0,0,0,0,0,0,0,0,0,0,0,0,0,0,0,0,0,0,0,0
2356,Gujarat,2008,07. Importation of Girls,0,0,0,0,0,0,0,0,0,0,0,0,0,0,0,0,0,0,0,0,0,0,0,0,0,0,0,0,0,0
2357,Haryana,2008,07. Importation of Girls,0,0,0,0,0,0,0,0,0,0,0,0,0,0,0,0,0,0,0,0,0,0,0,0,0,0,0,0,0,0
2358,Himachal Pradesh,2008,07. Importation of Girls,0,0,0,0,0,0,0,0,0,0,0,0,0,0,0,0,0,0,0,0,0,0,0,0,0,0,0,0,0,0
2359,Jammu & Kashmir,2008,07. Importation of Girls,0,0,0,0,0,0,0,0,0,0,0,0,0,0,0,0,0,0,0,0,0,0,0,0,0,0,0,0,0,0
2360,Jharkhand,2008,07. Importation of Girls,19,11,26,2,4,8,37,0,8,14,7,6,39,26,23,0,0,32,19,0,63,61,4,0,2,39,0,23,1,62
2361,Karnataka,2008,07. Importation of Girls,0,0,0,0,0,0,0,0,1,0,0,0,1,0,0,0,0,0,0,0,0,0,0,0,0,0,0,0,0,0
2362,Kerala,2008,07. Importation of Girls,0,0,0,0,0,0,0,0,0,0,0,0,0,0,0,0,0,0,0,0,0,0,0,0,0,0,0,0,0,0
2363,Lakshadweep,2008,07. Importation of Girls,0,0,0,0,0,0,0,0,0,0,0,0,0,0,0,0,0,0,0,0,0,0,0,0,0,0,0,0,0,0
2364,Madhya Pradesh,2008,07. Importation of Girls,0,0,0,0,0,0,0,0,0,0,2,2,0,0,0,0,0,2,0,0,0,0,0,0,0,4,0,0,4,4
2365,Maharashtra,2008,07. Importation of Girls,0,0,0,0,0,0,0,0,0,0,0,0,0,0,0,0,0,0,0,0,0,0,0,0,0,0,0,0,0,0
2366,Manipur,2008,07. Importation of Girls,0,0,0,0,0,0,0,0,0,0,0,0,0,0,0,0,0,0,0,0,0,0,0,0,0,0,0,0,0,0
2367,Meghalaya,2008,07. Importation of Girls,0,0,0,0,0,0,0,0,0,0,0,0,0,0,0,0,0,0,0,0,0,0,0,0,0,0,0,0,0,0
2368,Mizoram,2008,07. Importation of Girls,0,0,0,0,0,0,0,0,0,0,0,0,0,0,0,0,0,0,0,0,0,0,0,0,0,0,0,0,0,0
2369,Nagaland,2008,07. Importation of Girls,0,0,0,0,0,0,0,0,0,0,0,0,0,0,0,0,0,0,0,0,0,0,0,0,0,0,0,0,0,0
2370,Odisha,2008,07. Importation of Girls,0,0,0,0,0,0,0,0,0,0,12,12,0,0,0,0,0,12,0,0,0,0,0,0,0,0,0,0,0,0
2371,Puducherry,2008,07. Importation of Girls,0,0,0,0,0,0,0,0,0,0,0,0,0,0,0,0,0,0,0,0,0,0,0,0,0,0,0,0,0,0
2372,Punjab,2008,07. Importation of Girls,0,2,0,0,0,0,2,0,0,2,0,0,0,0,0,0,0,0,0,0,0,0,0,6,6,0,0,0,0,0
2373,Rajasthan,2008,07. Importation of Girls,1,0,0,0,0,0,0,0,0,0,1,2,0,0,1,0,0,2,1,0,0,0,0,0,0,1,0,1,2,2
2374,Sikkim,2008,07. Importation of Girls,0,0,0,0,0,0,0,0,0,0,0,0,0,0,0,0,0,0,0,0,0,0,0,0,0,0,0,0,0,0
2375,Tamil Nadu,2008,07. Importation of Girls,0,0,0,0,0,0,0,0,0,0,0,0,0,0,0,0,0,0,0,0,0,0,0,0,0,0,0,0,0,0
2376,Tripura,2008,07. Importation of Girls,0,0,0,0,0,0,0,0,0,0,0,0,0,0,0,0,0,0,0,0,0,0,0,0,0,0,0,0,0,0
2377,Uttar Pradesh,2008,07. Importation of Girls,0,0,0,0,0,0,0,0,0,0,0,0,0,0,0,0,0,0,0,0,0,0,0,0,0,0,0,0,0,0
2378,Uttarakhand,2008,07. Importation of Girls,0,0,0,0,0,0,0,0,0,0,0,0,0,0,0,0,0,0,0,0,0,0,0,0,0,0,0,0,0,0
2379,West Bengal,2008,07. Importation of Girls,11,11,5,0,1,0,16,0,16,27,20,27,5,5,12,0,0,32,29,5,6,13,1,17,2,41,8,30,63,76
2380,Andaman & Nicobar Islands,2009,07. Importation of Girls,0,0,0,0,0,0,0,0,0,0,0,0,0,0,0,0,0,0,0,0,0,0,0,0,0,0,0,0,0,0
2381,Andhra Pradesh,2009,07. Importation of Girls,0,0,0,0,0,0,0,0,0,0,1,1,0,0,0,0,0,1,0,0,0,0,0,0,0,2,0,0,2,2
2382,Arunachal Pradesh,2009,07. Importation of Girls,0,0,0,0,0,0,0,0,0,0,0,0,0,0,0,0,0,0,0,0,0,0,0,0,0,0,0,0,0,0
2383,Assam,2009,07. Importation of Girls,0,0,1,0,0,0,1,0,0,0,2,1,1,1,0,0,0,2,0,0,1,1,0,0,0,2,0,0,1,2
2384,Bihar,2009,07. Importation of Girls,2,0,23,0,4,5,23,0,33,30,227,210,31,23,6,0,0,233,6,0,17,36,8,50,31,448,0,14,426,462
2385,Chandigarh,2009,07. Importation of Girls,0,0,0,0,0,0,0,0,0,0,0,0,0,0,0,0,0,0,0,0,0,0,0,0,0,0,0,0,0,0
2386,Chhattisgarh,2009,07. Importation of Girls,0,0,0,0,0,0,0,0,0,0,0,0,0,0,0,0,0,0,0,0,0,0,0,0,0,0,0,0,0,0
2387,Dadra & Nagar Haveli,2009,07. Importation of Girls,0,0,0,0,0,0,0,0,0,0,0,0,0,0,0,0,0,0,0,0,0,0,0,0,0,0,0,0,0,0
2388,Daman & Diu,2009,07. Importation of Girls,0,0,0,0,0,0,0,0,0,0,0,0,0,0,0,0,0,0,0,0,0,0,0,0,0,0,0,0,0,0
2389,Delhi,2009,07. Importation of Girls,0,0,0,0,0,0,0,0,1,1,0,0,0,0,0,0,0,0,0,0,0,0,0,0,0,0,0,0,0,0
2390,Goa,2009,07. Importation of Girls,0,0,0,0,0,0,0,0,0,0,0,0,0,0,0,0,0,0,0,0,0,0,0,0,0,0,0,0,0,0
2391,Gujarat,2009,07. Importation of Girls,0,0,0,0,0,0,0,0,0,0,0,0,0,0,0,0,0,0,0,0,0,0,0,0,0,0,0,0,0,0
2392,Haryana,2009,07. Importation of Girls,0,0,0,0,0,0,0,0,0,0,0,0,0,0,0,0,0,0,0,0,0,0,0,0,0,0,0,0,0,0
2393,Himachal Pradesh,2009,07. Importation of Girls,0,0,0,0,0,0,0,0,0,0,0,0,0,0,0,0,0,0,0,0,0,0,0,0,0,0,0,0,0,0
2394,Jammu & Kashmir,2009,07. Importation of Girls,0,0,0,0,0,0,0,0,0,0,0,0,0,0,0,0,0,0,0,0,0,0,0,0,0,0,0,0,0,0
2395,Jharkhand,2009,07. Importation of Girls,2,3,7,0,2,0,10,0,4,8,10,7,6,7,4,0,0,14,5,0,20,5,4,2,17,35,0,9,39,44
2396,Karnataka,2009,07. Importation of Girls,0,0,0,0,0,0,0,0,3,1,0,0,2,0,0,0,0,0,0,0,0,0,0,0,0,0,0,0,0,0
2397,Kerala,2009,07. Importation of Girls,0,0,0,0,0,0,0,0,0,0,0,0,0,0,0,0,0,0,0,0,0,0,0,0,0,0,0,0,0,0
2398,Lakshadweep,2009,07. Importation of Girls,0,0,0,0,0,0,0,0,0,0,0,0,0,0,0,0,0,0,0,0,0,0,0,0,0,0,0,0,0,0
2399,Madhya Pradesh,2009,07. Importation of Girls,0,0,1,0,0,0,1,0,0,0,3,2,1,1,0,0,0,3,0,0,2,2,0,0,0,6,0,0,4,6
2400,Maharashtra,2009,07. Importation of Girls,0,0,0,0,0,0,0,0,0,0,0,0,0,0,0,0,0,0,0,0,0,0,0,0,0,0,0,0,0,0
2401,Manipur,2009,07. Importation of Girls,0,0,0,0,0,0,0,0,0,0,0,0,0,0,0,0,0,0,0,0,0,0,0,0,0,0,0,0,0,0
2402,Meghalaya,2009,07. Importation of Girls,0,0,1,0,0,0,1,0,0,0,1,0,1,1,0,0,0,1,0,0,2,2,0,0,0,2,0,0,0,2
2403,Mizoram,2009,07. Importation of Girls,0,0,0,0,0,0,0,0,0,0,0,0,0,0,0,0,0,0,0,0,0,0,0,0,0,0,0,0,0,0
2404,Nagaland,2009,07. Importation of Girls,0,0,0,0,0,0,0,0,0,0,0,0,0,0,0,0,0,0,0,0,0,0,0,0,0,0,0,0,0,0
2405,Odisha,2009,07. Importation of Girls,0,0,0,0,0,1,0,0,0,0,12,12,1,0,0,0,0,12,0,0,0,0,0,0,0,0,0,0,0,0
2406,Puducherry,2009,07. Importation of Girls,0,0,0,0,0,0,0,0,0,0,0,0,0,0,0,0,0,0,0,0,0,0,0,0,0,0,0,0,0,0
2407,Punjab,2009,07. Importation of Girls,0,0,0,0,0,0,0,0,0,0,0,0,0,0,0,0,0,0,0,0,0,0,0,0,0,0,0,0,0,0
2408,Rajasthan,2009,07. Importation of Girls,0,0,0,0,0,0,0,0,0,0,1,1,0,0,0,0,0,1,0,0,0,0,0,0,0,1,0,0,1,1
2409,Sikkim,2009,07. Importation of Girls,0,0,0,0,0,0,0,0,0,0,0,0,0,0,0,0,0,0,0,0,0,0,0,0,0,0,0,0,0,0
2410,Tamil Nadu,2009,07. Importation of Girls,0,0,0,0,0,0,0,0,0,0,0,0,0,0,0,0,0,0,0,0,0,0,0,0,0,0,0,0,0,0
2411,Tripura,2009,07. Importation of Girls,0,0,0,0,0,0,0,0,0,0,0,0,0,0,0,0,0,0,0,0,0,0,0,0,0,0,0,0,0,0
2412,Uttar Pradesh,2009,07. Importation of Girls,0,0,0,0,0,0,0,0,0,0,0,0,0,0,0,0,0,0,0,0,0,0,0,0,0,0,0,0,0,0
2413,Uttarakhand,2009,07. Importation of Girls,0,0,0,0,0,0,0,0,0,0,0,0,0,0,0,0,0,0,0,0,0,0,0,0,0,0,0,0,0,0
2414,West Bengal,2009,07. Importation of Girls,11,2,9,0,0,0,11,0,10,16,18,20,5,9,11,0,0,29,17,4,7,4,0,2,4,24,1,17,41,45
2415,Andaman & Nicobar Islands,2010,07. Importation of Girls,0,0,0,0,0,0,0,0,0,0,0,0,0,0,0,0,0,0,0,0,0,0,0,0,0,0,0,0,0,0
2416,Andhra Pradesh,2010,07. Importation of Girls,0,0,0,0,0,0,0,0,0,0,1,1,0,0,0,0,0,1,0,0,0,0,0,0,0,2,0,0,2,2
2417,Arunachal Pradesh,2010,07. Importation of Girls,0,0,0,0,0,0,0,0,0,0,0,0,0,0,0,0,0,0,0,0,0,0,0,0,0,0,0,0,0,0
2418,Assam,2010,07. Importation of Girls,0,0,0,0,0,0,0,0,0,0,2,2,0,0,0,0,0,2,0,0,0,0,0,0,0,2,0,0,2,2
2419,Bihar,2010,07. Importation of Girls,5,1,9,0,1,0,10,0,31,33,230,227,8,9,6,0,0,236,10,0,26,18,1,31,39,455,0,11,448,466
2420,Chandigarh,2010,07. Importation of Girls,0,0,0,0,0,0,0,0,0,0,0,0,0,0,0,0,0,0,0,0,0,0,0,0,0,0,0,0,0,0
2421,Chhattisgarh,2010,07. Importation of Girls,0,0,2,0,0,0,2,0,0,0,2,0,2,2,0,0,0,2,0,0,5,5,0,0,0,5,0,0,0,5
2422,Dadra & Nagar Haveli,2010,07. Importation of Girls,0,0,0,0,0,0,0,0,0,0,0,0,0,0,0,0,0,0,0,0,0,0,0,0,0,0,0,0,0,0
2423,Daman & Diu,2010,07. Importation of Girls,0,0,0,0,0,0,0,0,0,0,0,0,0,0,0,0,0,0,0,0,0,0,0,0,0,0,0,0,0,0
2424,Delhi,2010,07. Importation of Girls,0,0,0,0,0,0,0,0,1,1,0,0,0,0,0,0,0,0,0,0,0,0,0,0,0,0,0,0,0,0
2425,Goa,2010,07. Importation of Girls,0,0,0,0,0,0,0,0,0,0,0,0,0,0,0,0,0,0,0,0,0,0,0,0,0,0,0,0,0,0
2426,Gujarat,2010,07. Importation of Girls,0,0,0,0,0,0,0,0,0,0,0,0,0,0,0,0,0,0,0,0,0,0,0,0,0,0,0,0,0,0
2427,Haryana,2010,07. Importation of Girls,0,0,0,0,0,0,0,0,0,0,0,0,0,0,0,0,0,0,0,0,0,0,0,0,0,0,0,0,0,0
2428,Himachal Pradesh,2010,07. Importation of Girls,0,0,0,0,0,0,0,0,0,0,0,0,0,0,0,0,0,0,0,0,0,0,0,0,0,0,0,0,0,0
2429,Jammu & Kashmir,2010,07. Importation of Girls,0,0,0,0,0,0,0,0,0,0,0,0,0,0,0,0,0,0,0,0,0,0,0,0,0,0,0,0,0,0
2430,Jharkhand,2010,07. Importation of Girls,1,2,3,0,3,0,5,0,7,4,9,10,8,3,4,0,0,13,5,0,15,20,5,17,12,45,0,10,35,55
2431,Karnataka,2010,07. Importation of Girls,0,0,0,0,0,3,0,0,0,3,0,0,0,0,0,0,0,0,0,0,0,0,0,0,0,0,0,0,0,0
2432,Kerala,2010,07. Importation of Girls,0,0,0,0,0,0,0,0,0,0,0,0,0,0,0,0,0,0,0,0,0,0,0,0,0,0,0,0,0,0
2433,Lakshadweep,2010,07. Importation of Girls,0,0,0,0,0,0,0,0,0,0,0,0,0,0,0,0,0,0,0,0,0,0,0,0,0,0,0,0,0,0
2434,Madhya Pradesh,2010,07. Importation of Girls,1,0,5,0,0,0,5,0,0,0,7,3,5,5,1,0,0,8,2,0,19,19,0,0,0,23,0,2,6,25
2435,Maharashtra,2010,07. Importation of Girls,0,0,0,0,0,0,0,0,0,0,0,0,0,0,0,0,0,0,0,0,0,0,0,0,0,0,0,0,0,0
2436,Manipur,2010,07. Importation of Girls,0,0,0,0,0,0,0,0,0,0,0,0,0,0,0,0,0,0,0,0,0,0,0,0,0,0,0,0,0,0
2437,Meghalaya,2010,07. Importation of Girls,1,0,0,0,0,0,0,0,0,0,0,1,0,0,1,0,0,1,2,0,0,0,0,0,0,0,0,2,2,2
2438,Mizoram,2010,07. Importation of Girls,0,0,0,0,0,0,0,0,0,0,0,0,0,0,0,0,0,0,0,0,0,0,0,0,0,0,0,0,0,0
2439,Nagaland,2010,07. Importation of Girls,0,0,0,0,0,0,0,0,0,0,0,0,0,0,0,0,0,0,0,0,0,0,0,0,0,0,0,0,0,0
2440,Odisha,2010,07. Importation of Girls,0,0,2,0,0,0,2,0,3,0,14,12,5,2,0,0,0,14,0,0,5,5,0,0,0,5,0,0,0,5
2441,Puducherry,2010,07. Importation of Girls,0,0,0,0,0,0,0,0,0,0,0,0,0,0,0,0,0,0,0,0,0,0,0,0,0,0,0,0,0,0
2442,Punjab,2010,07. Importation of Girls,0,0,0,0,0,0,0,0,0,0,0,0,0,0,0,0,0,0,0,0,0,0,0,0,0,0,0,0,0,0
2443,Rajasthan,2010,07. Importation of Girls,0,0,0,0,0,0,0,0,0,0,1,1,0,0,0,0,0,1,0,0,0,0,0,0,0,1,0,0,1,1
2444,Sikkim,2010,07. Importation of Girls,0,0,0,0,0,0,0,0,0,0,0,0,0,0,0,0,0,0,0,0,0,0,0,0,0,0,0,0,0,0
2445,Tamil Nadu,2010,07. Importation of Girls,0,0,0,0,0,0,0,0,0,0,0,0,0,0,0,0,0,0,0,0,0,0,0,0,0,0,0,0,0,0
2446,Tripura,2010,07. Importation of Girls,0,0,0,0,0,0,0,0,0,0,0,0,0,0,0,0,0,0,0,0,0,0,0,0,0,0,0,0,0,0
2447,Uttar Pradesh,2010,07. Importation of Girls,0,0,0,0,0,0,0,0,0,0,0,0,0,0,0,0,0,0,0,0,0,0,0,0,0,0,0,0,0,0
2448,Uttarakhand,2010,07. Importation of Girls,0,0,0,0,0,0,0,0,0,0,0,0,0,0,0,0,0,0,0,0,0,0,0,0,0,0,0,0,0,0
2449,West Bengal,2010,07. Importation of Girls,8,0,8,0,0,0,8,0,10,10,18,18,8,8,8,0,0,26,19,0,11,8,0,4,7,13,0,19,24,32
3850,Andaman & Nicobar Islands,2001,12. Total Crimes Against Women,14,6,40,0,0,0,46,0,6,18,170,144,34,40,14,0,0,184,16,0,34,49,0,33,18,204,0,16,171,220
3851,Andhra Pradesh,2001,12. Total Crimes Against Women,6773,236,13848,1849,4765,2067,14084,88,4266,4028,18625,18205,16477,13848,11538,41,0,32012,10962,2588,22218,19991,4142,5485,6862,29935,850,15104,27636,47627
3852,Arunachal Pradesh,2001,12. Total Crimes Against Women,12,22,138,7,36,0,160,0,49,29,684,601,180,138,48,0,0,739,15,9,218,169,40,70,70,854,49,55,749,918
3853,Assam,2001,12. Total Crimes Against Women,1289,1031,2115,154,302,322,3146,4,4919,4148,6984,6614,4243,2115,1591,0,0,8729,1859,234,5497,3120,410,3930,4700,10002,1607,2269,9385,12505
3854,Bihar,2001,12. Total Crimes Against Women,1760,627,4307,196,768,401,4934,0,3114,3093,15080,13497,5356,4307,2528,0,0,17804,5052,611,13034,10975,1495,5878,6319,39450,1618,6547,35633,46608
3855,Chandigarh,2001,12. Total Crimes Against Women,45,24,95,0,28,30,119,0,43,42,265,243,150,95,73,0,0,338,99,0,174,199,42,78,24,679,29,141,621,820
3856,Chhattisgarh,2001,12. Total Crimes Against Women,1057,64,4004,466,619,27,4068,4,190,300,14963,13101,3989,4004,1676,0,0,17105,1613,669,5312,5426,1108,199,81,21449,4,2721,19413,24839
3857,Dadra & Nagar Haveli,2001,12. Total Crimes Against Women,4,3,20,0,2,0,23,0,7,11,63,49,19,20,6,0,0,69,15,0,24,25,2,6,5,105,0,17,97,122
3858,Daman & Diu,2001,12. Total Crimes Against Women,6,2,8,0,0,0,10,0,2,2,12,10,10,8,6,0,0,18,15,0,42,46,0,7,1,55,2,15,24,70
3859,Delhi,2001,12. Total Crimes Against Women,1175,705,1615,0,813,200,2320,0,1392,1621,4592,4965,2291,1615,1988,0,0,6580,774,0,3124,2906,883,915,997,13190,136,1657,11941,14847
3860,Goa,2001,12. Total Crimes Against Women,88,11,81,8,89,1,92,0,22,32,194,298,83,81,177,0,0,379,166,10,186,191,151,39,30,379,4,317,515,706
3861,Gujarat,2001,12. Total Crimes Against Women,2351,232,5418,425,147,255,5650,18,346,464,29120,26625,5805,5418,2498,0,0,32043,6062,842,13464,13740,256,912,615,68189,21,6318,61609,75349
3862,Haryana,2001,12. Total Crimes Against Women,1787,337,2576,24,745,495,2913,0,336,351,7424,7404,3393,2576,2532,0,0,9980,4345,11,5845,5844,1209,354,346,17320,9,5554,17041,22885
3863,Himachal Pradesh,2001,12. Total Crimes Against Women,403,13,763,168,65,146,776,0,148,180,2665,2540,890,763,468,2,0,3301,688,325,1372,1343,87,175,167,4814,37,775,4571,5914
3864,Jammu & Kashmir,2001,12. Total Crimes Against Women,731,57,1430,117,103,232,1487,1,457,521,4831,4352,1656,1430,834,0,0,5782,1470,224,2424,2390,104,46,8,11379,72,1574,10787,13177
3865,Jharkhand,2001,12. Total Crimes Against Women,998,238,1909,61,319,68,2147,3,737,726,5185,4654,2229,1909,1317,0,0,6563,1928,193,3750,3718,805,1994,1655,9595,371,2733,8803,12521
3866,Karnataka,2001,12. Total Crimes Against Women,2540,326,5528,583,1438,402,5854,64,999,1317,11453,10509,6002,5528,3978,23,0,16014,6251,932,9819,9527,2298,1313,1157,19754,448,8549,19708,29235
3867,Kerala,2001,12. Total Crimes Against Women,1868,73,4619,543,265,452,4692,65,1691,1450,14799,12856,5450,4619,2133,0,0,17475,3661,764,8076,7903,339,1847,1920,24633,100,4000,21494,29397
3868,Lakshadweep,2001,12. Total Crimes Against Women,0,0,1,0,0,0,1,0,0,1,1,0,0,1,0,0,0,1,0,0,0,1,0,1,0,1,0,0,0,1
3869,Madhya Pradesh,2001,12. Total Crimes Against Women,6040,437,13924,3054,2960,53,14361,10,793,821,42938,41134,14549,13924,9000,66,153,54992,9732,4620,22308,22125,4701,401,503,68977,81,14433,65905,88030
3870,Maharashtra,2001,12. Total Crimes Against Women,7469,306,12255,1958,659,165,12561,1,2181,2384,84840,82671,12524,12255,8128,0,0,94926,20149,3791,30600,30898,1445,4322,3920,186178,104,21594,180665,211563
3871,Manipur,2001,12. Total Crimes Against Women,3,147,10,0,8,0,157,0,112,157,70,71,112,10,11,0,0,81,3,0,102,17,1,65,40,157,110,4,144,161
3872,Meghalaya,2001,12. Total Crimes Against Women,22,20,48,0,2,0,68,0,108,110,417,393,66,48,24,0,0,441,26,0,54,52,2,103,92,499,13,28,475,527
3873,Mizoram,2001,12. Total Crimes Against Women,19,2,106,0,89,0,108,0,35,17,150,152,126,106,108,0,0,258,30,4,138,149,119,74,62,163,1,149,167,316
3874,Nagaland,2001,12. Total Crimes Against Women,2,4,16,1,4,0,20,0,39,29,95,86,30,16,6,0,0,102,0,4,38,16,7,37,57,102,2,7,97,113
3875,Odisha,2001,12. Total Crimes Against Women,2922,227,5061,1,499,195,5288,2,1655,1783,15270,13631,5357,5061,3421,0,0,18692,4707,12,7455,7307,784,279,376,24841,51,5491,23037,30344
3876,Puducherry,2001,12. Total Crimes Against Women,20,1,114,20,68,1,115,2,11,10,110,104,119,114,88,0,0,218,46,38,223,218,144,8,13,177,0,190,187,405
3877,Punjab,2001,12. Total Crimes Against Women,574,533,1310,47,242,320,1843,9,1377,1188,2625,2178,2361,1310,816,0,0,3488,1497,119,4664,3263,697,2647,3648,6383,400,2194,5433,8696
3878,Rajasthan,2001,12. Total Crimes Against Women,3591,268,7610,1042,2187,4563,7878,0,484,750,28069,27279,12175,7610,5778,0,0,34889,7006,1766,13831,13835,4116,117,109,57464,4,11122,56517,70352
3879,Sikkim,2001,12. Total Crimes Against Women,4,6,12,0,2,0,18,0,6,0,26,20,24,12,6,0,0,32,7,1,24,12,7,8,9,4,11,14,7,19
3880,Tamil Nadu,2001,12. Total Crimes Against Women,1824,158,9666,192,7225,468,9824,108,1077,1383,8622,8208,10111,9666,9049,11,17,17863,3429,214,14116,13403,8197,1990,2038,15392,665,11626,13829,27232
3881,Tripura,2001,12. Total Crimes Against Women,124,33,265,6,33,0,298,0,296,156,581,479,438,265,157,0,0,744,225,0,590,398,64,184,209,614,167,289,505,903
3882,Uttar Pradesh,2001,12. Total Crimes Against Women,4890,2908,15566,1107,6690,1548,18474,0,2638,2433,43454,40575,20227,15566,11580,0,0,56141,11266,3149,42283,38315,14657,4109,5254,110246,2823,25923,101003,139318
3883,Uttarakhand,2001,12. Total Crimes Against Women,226,124,572,32,326,58,696,0,77,82,1286,1298,749,572,552,0,0,1870,439,116,1436,1324,614,202,203,3139,111,1053,2984,4308
3884,West Bengal,2001,12. Total Crimes Against Women,2161,744,5976,21,282,297,6720,8,7040,7495,37643,34131,6570,5976,2443,0,0,40107,5675,13,11114,9618,544,7624,6875,50032,2245,6219,46646,56264
3885,Andaman & Nicobar Islands,2002,12. Total Crimes Against Women,14,6,23,0,4,0,29,0,4,6,175,170,27,23,18,0,0,193,18,0,30,43,4,18,4,225,1,22,204,247
3886,Andhra Pradesh,2002,12. Total Crimes Against Women,6231,240,15620,2144,5212,2932,15860,47,4307,4266,20649,18625,18880,15620,11443,9,0,34236,10203,2631,26627,23663,6772,6862,8657,33992,1169,16975,29935,53598
3887,Arunachal Pradesh,2002,12. Total Crimes Against Women,10,40,128,8,11,0,168,0,40,49,783,684,159,128,21,0,0,812,9,8,207,142,14,70,92,965,43,23,854,996
3888,Assam,2002,12. Total Crimes Against Women,1385,994,3014,156,320,412,4008,5,5586,4919,8137,6984,5092,3014,1705,0,0,9998,2200,269,6764,4205,396,4700,5777,11342,1482,2596,10002,14207
3889,Bihar,2002,12. Total Crimes Against Women,1869,745,4245,103,593,423,4990,0,3444,3114,16771,15091,5743,4245,2462,0,0,19336,4720,347,13009,11960,1263,6328,4700,45074,2677,5983,39444,51404
3890,Chandigarh,2002,12. Total Crimes Against Women,46,29,131,0,29,25,160,0,47,43,321,265,189,131,75,0,0,396,89,0,196,153,37,24,28,706,39,126,679,832
3891,Chhattisgarh,2002,12. Total Crimes Against Women,2187,46,3520,1163,1649,34,3566,7,120,189,13478,14957,3538,3520,3836,0,0,18477,4055,881,5107,5031,2356,85,154,18179,7,6411,20440,25471
3892,Dadra & Nagar Haveli,2002,12. Total Crimes Against Women,20,2,16,0,2,1,18,0,4,8,57,63,15,16,22,0,0,79,36,0,19,25,2,8,2,92,0,38,105,130
3893,Daman & Diu,2002,12. Total Crimes Against Women,5,3,5,0,0,0,8,0,2,2,12,12,8,5,5,0,0,17,30,0,14,12,0,1,3,37,0,30,55,67
3894,Delhi,2002,12. Total Crimes Against Women,583,373,1499,0,265,162,1872,40,1515,1392,5243,4592,2216,1499,848,0,19,6091,1231,0,3080,2745,437,997,1256,14267,76,1668,13190,15935
3895,Goa,2002,12. Total Crimes Against Women,33,6,63,4,45,0,69,0,29,22,174,194,76,63,78,1,0,256,57,10,135,129,98,30,32,343,4,155,379,508
3896,Gujarat,2002,12. Total Crimes Against Women,2375,228,4858,440,196,229,5086,14,390,346,30967,29120,5373,4858,2571,0,0,33978,5801,1106,12563,12519,286,615,643,73515,16,6087,68189,80708
3897,Haryana,2002,12. Total Crimes Against Women,1970,346,3546,87,1581,562,3892,0,267,336,7332,7424,4385,3546,3551,0,0,10970,4863,79,7031,7126,2023,346,245,17481,6,6886,17320,24446
3898,Himachal Pradesh,2002,12. Total Crimes Against Women,381,8,680,101,57,118,688,0,180,148,2806,2665,838,680,438,0,0,3345,706,186,1245,1182,79,167,196,5025,34,785,4814,5996
3899,Jammu & Kashmir,2002,12. Total Crimes Against Women,898,45,1647,91,152,212,1692,0,569,457,5337,4831,2016,1647,1050,0,0,6478,1893,184,2764,2716,213,8,44,11805,12,2106,11379,14095
3900,Jharkhand,2002,12. Total Crimes Against Women,1534,155,1959,88,400,85,2114,0,1158,867,7077,7155,2490,1959,1934,15,0,9099,3340,218,3765,3896,679,2122,1611,8601,380,4019,8942,12838
3901,Karnataka,2002,12. Total Crimes Against Women,2649,347,5338,534,1385,489,5685,67,928,999,12223,11453,6170,5338,4034,0,0,16791,5950,981,10047,9476,2202,1157,1364,20097,364,8152,19754,29230
3902,Kerala,2002,12. Total Crimes Against Women,1921,97,4987,479,266,603,5084,67,1766,1691,17120,14799,5829,4987,2187,0,0,19786,3856,727,8968,8884,594,1920,1891,28340,113,4450,24633,33517
3903,Lakshadweep,2002,12. Total Crimes Against Women,0,0,1,0,1,0,1,0,1,0,1,1,2,1,1,0,0,2,0,0,3,1,1,0,2,1,0,1,1,2
3904,Madhya Pradesh,2002,12. Total Crimes Against Women,5587,236,14984,3169,2605,182,15220,3,648,793,46559,42938,15260,14984,8192,2,0,57920,10525,4598,25388,25549,4862,503,341,74541,1,15387,68977,94526
3905,Maharashtra,2002,12. Total Crimes Against Women,8778,168,10764,1526,679,177,10932,1,2392,2180,84326,84545,11322,10764,9457,0,0,95309,21795,2897,30106,30321,1430,3919,3616,189996,88,23225,185797,216118
3906,Manipur,2002,12. Total Crimes Against Women,0,132,18,0,7,0,150,2,130,112,81,70,170,18,7,0,0,88,0,0,161,39,30,40,67,166,95,30,157,196
3907,Meghalaya,2002,12. Total Crimes Against Women,10,14,39,2,5,0,53,0,126,108,439,417,71,39,15,0,0,456,11,1,80,58,4,92,101,541,13,15,499,557
3908,Mizoram,2002,12. Total Crimes Against Women,14,3,95,0,48,0,98,0,72,16,136,103,154,95,62,0,0,198,8,0,155,159,92,43,39,182,0,100,123,282
3909,Nagaland,2002,12. Total Crimes Against Women,0,2,20,0,8,0,22,0,42,39,106,95,26,20,8,1,1,114,0,1,49,22,16,57,61,107,23,16,102,124
3910,Odisha,2002,12. Total Crimes Against Women,2453,160,4280,17,423,254,4440,3,1737,1655,16656,15270,4779,4280,2876,1,0,19549,4518,18,7413,7264,776,376,516,26793,9,5294,24841,32105
3911,Puducherry,2002,12. Total Crimes Against Women,21,0,130,19,52,2,130,3,17,11,148,110,141,130,73,0,0,240,45,20,246,233,105,13,26,240,0,150,177,410
3912,Punjab,2002,12. Total Crimes Against Women,644,365,1591,39,450,309,1956,25,1382,1377,3083,2625,2295,1591,1094,0,0,4216,1552,99,4724,4454,943,3648,3466,8243,452,2495,6383,10837
3913,Rajasthan,2002,12. Total Crimes Against Women,3994,235,7275,1099,2622,4333,7510,0,690,484,27629,28069,12049,7275,6616,0,0,35344,8803,2062,13295,13322,4873,109,77,55048,5,13676,57464,70786
3914,Sikkim,2002,12. Total Crimes Against Women,8,11,14,8,12,0,25,0,9,6,12,26,28,14,20,0,0,40,5,1,24,10,4,9,14,4,9,9,4,14
3915,Tamil Nadu,2002,12. Total Crimes Against Women,2266,143,8963,108,6231,621,9106,81,1050,1077,8980,8622,9798,8963,8497,0,17,17585,4976,103,12756,12815,8245,2038,1617,14883,362,13221,15392,28207
3916,Tripura,2002,12. Total Crimes Against Women,190,48,461,3,46,0,509,0,323,296,803,581,536,461,236,0,0,1042,344,20,558,414,55,209,219,609,134,399,614,1028
3917,Uttar Pradesh,2002,12. Total Crimes Against Women,5796,2189,13740,1192,7030,1451,15929,0,905,2638,43176,43454,15647,13740,12826,0,0,57194,14863,3189,35542,35692,17091,5254,2669,110795,2435,31954,110246,145938
3918,Uttarakhand,2002,12. Total Crimes Against Women,150,143,646,25,258,59,789,0,99,77,1499,1286,870,646,408,0,0,1932,292,48,1750,1244,483,203,247,3560,462,775,3139,4383
3919,West Bengal,2002,12. Total Crimes Against Women,4192,774,6999,10,805,52,7773,8,6049,7040,39635,37643,6842,6999,4997,0,0,44642,7061,20,14160,10990,1178,6875,8693,52763,1352,8239,50032,61022
3920,Andaman & Nicobar Islands,2003,12. Total Crimes Against Women,11,1,18,0,3,0,19,0,7,4,179,175,22,18,14,0,0,193,13,0,36,24,3,4,12,233,4,16,225,249
3921,Andhra Pradesh,2003,12. Total Crimes Against Women,7092,235,14349,2341,3613,3428,14584,119,4557,4307,21951,20649,18382,14349,10705,1,1,34997,15118,3961,29101,28602,4819,8657,8195,38696,961,19937,33992,62594
3922,Arunachal Pradesh,2003,12. Total Crimes Against Women,2,30,100,1,4,0,130,0,49,40,876,783,139,100,6,0,0,883,2,0,160,87,2,92,94,1048,71,4,965,1052
3923,Assam,2003,12. Total Crimes Against Women,1827,1266,3318,338,342,767,4584,11,5536,5586,8948,8137,5312,3318,2169,0,0,11455,3062,589,7551,4995,521,5777,6183,12165,2150,3583,11342,16337
3924,Bihar,2003,12. Total Crimes Against Women,2450,739,4067,239,643,372,4806,0,4166,3444,17497,16771,5900,4067,3093,9,0,20829,5937,811,11323,9444,1447,4700,4677,46323,1902,7384,45074,54518
3925,Chandigarh,2003,12. Total Crimes Against Women,31,21,91,0,23,32,112,0,62,47,358,321,159,91,54,0,0,412,94,0,206,154,24,28,54,742,26,118,706,860
3926,Chhattisgarh,2003,12. Total Crimes Against Women,937,54,3104,1340,711,32,3158,4,275,133,13579,13463,3336,3104,1648,0,0,16567,1751,1753,4869,4866,1048,162,164,20365,1,2799,20051,24917
3927,Dadra & Nagar Haveli,2003,12. Total Crimes Against Women,7,1,8,0,2,1,9,0,7,4,56,57,13,8,9,0,0,65,14,0,24,18,5,2,7,96,1,19,97,115
3928,Daman & Diu,2003,12. Total Crimes Against Women,2,3,5,0,0,0,8,0,4,2,13,10,10,5,2,0,0,15,2,0,10,8,5,3,4,39,1,7,38,46
3929,Delhi,2003,12. Total Crimes Against Women,888,410,1714,0,322,230,2124,41,2397,1515,5747,5243,3282,1714,1210,0,5,6957,1827,0,4789,4408,657,1256,1563,16191,74,2484,14267,18675
3930,Goa,2003,12. Total Crimes Against Women,32,11,76,7,35,0,87,0,63,29,176,174,121,76,67,0,0,250,62,10,191,143,85,32,70,329,10,147,343,486
3931,Gujarat,2003,12. Total Crimes Against Women,2461,270,5173,345,155,260,5443,14,408,390,33179,30967,5735,5173,2616,0,0,36140,5771,820,14060,13948,404,643,727,80468,28,6175,73515,87463
3932,Haryana,2003,12. Total Crimes Against Women,1738,275,3308,27,1495,619,3583,0,235,267,7380,7332,4170,3308,3233,0,0,10640,4237,15,6524,6553,2008,245,214,17774,2,6245,17481,24034
3933,Himachal Pradesh,2003,12. Total Crimes Against Women,432,13,639,121,77,107,652,0,150,180,2815,2806,729,639,509,0,0,3445,763,286,1083,1113,101,196,131,4988,35,864,5025,6138
3934,Jammu & Kashmir,2003,12. Total Crimes Against Women,761,30,1963,62,197,205,1993,0,535,569,6280,5337,2164,1963,958,0,0,7300,1314,137,3580,3606,282,44,15,13678,3,1596,11805,15411
3935,Jharkhand,2003,12. Total Crimes Against Women,1437,192,1971,103,357,65,2163,3,1415,1158,6993,7077,2488,1971,1794,158,0,8890,2105,214,3931,3515,725,1611,1760,9072,267,2830,8601,12116
3936,Karnataka,2003,12. Total Crimes Against Women,2655,215,5231,500,1422,406,5446,86,824,928,12877,12223,5834,5231,4077,0,0,17454,5808,645,10376,9632,2308,1364,1207,20968,901,8116,20097,29729
3937,Kerala,2003,12. Total Crimes Against Women,2266,108,4726,638,362,572,4834,74,1939,1766,18575,17120,5653,4726,2628,5,0,21841,4131,1143,8726,8170,578,1891,2150,30658,297,4709,28340,36510
3938,Lakshadweep,2003,12. Total Crimes Against Women,0,0,1,0,1,0,1,0,4,1,1,1,4,1,1,0,0,2,0,0,3,2,1,2,3,2,0,1,1,3
3939,Madhya Pradesh,2003,12. Total Crimes Against Women,7042,213,13996,3143,3488,144,14209,0,774,580,46341,46018,14547,13996,10530,0,0,60014,11152,4704,24089,24024,5562,258,321,81366,2,16714,78760,102784
3940,Maharashtra,2003,12. Total Crimes Against Women,7553,257,10729,1357,697,129,10986,0,2549,2392,85447,84326,11273,10729,8250,1,1,95054,20729,2383,29336,28619,1238,3616,4253,194265,80,21967,189996,218615
3941,Manipur,2003,12. Total Crimes Against Women,3,89,7,0,2,0,96,0,171,130,83,81,137,7,5,0,0,88,3,0,150,7,3,67,114,167,96,6,166,173
3942,Meghalaya,2003,12. Total Crimes Against Women,11,12,36,0,5,0,48,0,147,126,459,439,69,36,16,0,0,475,10,0,82,23,3,101,150,551,10,13,541,564
3943,Mizoram,2003,12. Total Crimes Against Women,11,6,160,1,67,0,166,0,26,45,268,187,147,160,78,0,0,347,18,0,173,144,200,37,66,106,0,218,180,324
3944,Nagaland,2003,12. Total Crimes Against Women,2,6,16,3,9,0,22,0,45,42,108,106,25,16,11,0,0,122,1,2,30,22,16,61,62,110,7,17,107,129
3945,Odisha,2003,12. Total Crimes Against Women,2555,167,4902,0,516,316,5069,3,1295,1737,18487,16656,4946,4902,3071,0,0,21558,4994,19,7805,7846,907,516,469,28719,6,5901,26793,34639
3946,Puducherry,2003,12. Total Crimes Against Women,22,1,107,22,29,3,108,2,25,17,182,148,121,107,51,0,0,255,45,39,221,219,90,26,28,285,0,135,240,459
3947,Punjab,2003,12. Total Crimes Against Women,786,371,1760,31,488,412,2131,12,1202,1382,3538,3083,2375,1760,1274,0,0,4843,1690,168,4192,3637,1126,3466,3491,8896,530,2816,8243,11880
3948,Rajasthan,2003,12. Total Crimes Against Women,3348,222,7151,1001,2062,4300,7373,0,829,690,28369,27629,11812,7151,5410,0,0,34780,6577,2074,12692,12669,3526,77,96,55540,4,10103,55048,67717
3949,Sikkim,2003,12. Total Crimes Against Women,5,5,25,14,9,1,30,0,15,9,9,12,37,25,14,0,0,37,3,2,36,24,3,14,19,20,7,6,4,28
3950,Tamil Nadu,2003,12. Total Crimes Against Women,2571,195,7541,54,3920,584,7736,60,1539,1051,10090,9106,8888,7541,6491,12,20,16635,4329,163,11721,11062,5378,1693,2171,16161,181,9707,14969,26031
3951,Tripura,2003,12. Total Crimes Against Women,195,110,450,0,80,0,560,0,300,323,978,803,537,450,275,0,0,1253,272,0,878,568,70,219,337,835,192,342,609,1177
3952,Uttar Pradesh,2003,12. Total Crimes Against Women,4725,820,11057,841,6322,733,11877,4,1131,905,42342,43176,12840,11057,11047,3,0,54230,10558,2544,23433,23406,13286,2669,2338,107813,358,23844,110795,134201
3953,Uttarakhand,2003,12. Total Crimes Against Women,154,122,654,38,313,69,776,0,140,99,1648,1499,886,654,467,0,0,2153,286,89,1827,1594,577,247,259,4202,221,863,3560,5154
3954,West Bengal,2003,12. Total Crimes Against Women,3555,454,7851,25,434,126,8305,8,6118,6049,43472,39635,8508,7851,3989,0,0,47486,7729,34,15992,14006,882,8693,8883,58124,1796,8611,52763,66769
3955,Andaman & Nicobar Islands,2004,12. Total Crimes Against Women,10,4,17,0,8,0,21,0,13,7,178,179,27,17,18,0,0,196,14,0,44,38,12,12,18,246,0,26,234,272
3956,Andhra Pradesh,2004,12. Total Crimes Against Women,7584,454,14411,2637,3326,2592,14865,63,5958,4557,22812,21951,18921,14411,10910,3,0,36359,13222,4776,28976,27139,5761,8195,8899,42076,1133,18983,38696,65835
3957,Arunachal Pradesh,2004,12. Total Crimes Against Women,4,26,100,4,11,0,126,0,71,49,957,876,148,100,15,0,0,976,6,6,162,118,17,94,85,1137,53,23,1048,1166
3958,Assam,2004,12. Total Crimes Against Women,2195,1348,3527,299,427,615,4875,1,5745,5536,9554,8948,5700,3527,2622,0,0,12475,3942,528,8117,5578,692,6183,6422,12581,2300,4634,12165,17743
3959,Bihar,2004,12. Total Crimes Against Women,2654,716,3989,92,530,420,4705,0,7132,4166,18210,17497,8091,3989,3184,0,0,21486,6051,245,12334,8997,930,4677,5725,48094,2289,6981,46323,55320
3960,Chandigarh,2004,12. Total Crimes Against Women,58,6,147,0,16,49,153,0,48,62,431,358,188,147,74,0,0,505,85,0,331,261,79,54,66,839,58,164,742,1003
3961,Chhattisgarh,2004,12. Total Crimes Against Women,1665,50,3767,1490,924,53,3817,2,166,275,13267,13579,3763,3767,2589,0,0,17346,3221,2744,6051,6130,1612,164,40,18918,45,4833,20365,26495
3962,Dadra & Nagar Haveli,2004,12. Total Crimes Against Women,18,0,18,0,0,0,18,0,11,7,54,54,22,18,18,0,0,72,28,0,32,29,0,7,10,97,0,28,96,125
3963,Daman & Diu,2004,12. Total Crimes Against Women,3,0,8,0,0,0,8,0,3,4,20,15,7,8,3,0,0,23,12,0,15,17,0,4,2,43,0,12,38,55
3964,Delhi,2004,12. Total Crimes Against Women,1313,414,2185,0,694,237,2599,32,3196,2397,5925,5747,3677,2185,2007,0,10,7932,1391,0,5196,4688,799,1563,2005,18689,66,2190,16191,20879
3965,Goa,2004,12. Total Crimes Against Women,36,25,105,9,29,0,130,0,65,63,207,176,132,105,65,0,0,281,70,18,227,189,56,70,94,374,14,126,329,518
3966,Gujarat,2004,12. Total Crimes Against Women,2557,210,5749,400,215,189,5959,6,465,408,35756,33179,6211,5749,2772,0,0,38928,6036,964,15549,15543,297,727,713,88714,20,6333,80468,96011
3967,Haryana,2004,12. Total Crimes Against Women,2010,283,3081,3,1276,747,3364,0,400,235,7172,7380,4276,3081,3286,0,0,10461,5034,9,6610,6404,1965,214,414,17170,6,6999,17774,24178
3968,Himachal Pradesh,2004,12. Total Crimes Against Women,474,16,681,193,70,119,697,0,157,150,2759,2815,823,681,544,0,0,3496,714,268,1203,1103,87,131,188,5022,43,801,4988,6091
3969,Jammu & Kashmir,2004,12. Total Crimes Against Women,984,61,1892,66,160,198,1953,0,592,535,6962,6280,2208,1892,1144,0,0,8172,2105,124,3345,3313,188,15,25,14574,22,2293,13678,16991
3970,Jharkhand,2004,12. Total Crimes Against Women,1437,192,1969,103,357,65,2161,3,1676,1415,6907,6993,2490,1969,1794,158,0,8804,2063,214,3931,3514,725,1760,1910,9584,267,2788,9072,12586
3971,Karnataka,2004,12. Total Crimes Against Women,3194,176,4711,376,1366,375,4887,55,917,824,12651,12877,5423,4711,4560,1,13,17587,5256,690,9154,9272,2440,1207,822,21854,267,7696,20968,30240
3972,Kerala,2004,12. Total Crimes Against Women,2844,131,5731,922,477,586,5862,90,1884,1939,20062,18575,6483,5731,3321,1,0,24305,5650,1255,9849,9572,737,2150,2204,32588,223,6387,30658,40230
3973,Lakshadweep,2004,12. Total Crimes Against Women,0,0,4,0,1,0,4,0,1,4,3,0,1,4,1,0,0,4,0,0,1,2,2,3,2,2,0,2,2,4
3974,Madhya Pradesh,2004,12. Total Crimes Against Women,6874,173,15056,3259,3518,143,15229,0,605,774,47746,46341,15203,15056,10392,0,0,61397,10778,5383,27027,27087,5412,321,255,86880,6,16190,81366,108453
3975,Maharashtra,2004,12. Total Crimes Against Women,7238,203,11381,1432,631,164,11584,3,2966,2549,87527,85447,12169,11381,7869,0,1,96828,18609,2963,30432,30240,1177,4253,4320,201756,125,19786,194265,224505
3976,Manipur,2004,12. Total Crimes Against Women,4,61,6,0,0,0,67,2,236,171,85,83,134,6,4,0,0,89,8,1,132,6,0,114,124,164,116,8,167,173
3977,Meghalaya,2004,12. Total Crimes Against Women,10,14,43,2,4,0,57,0,203,147,486,459,113,43,14,0,0,502,11,2,96,50,4,150,180,584,16,15,551,601
3978,Mizoram,2004,12. Total Crimes Against Women,41,13,78,1,182,0,91,0,26,26,122,268,91,78,223,0,0,346,3,1,79,58,8,66,80,152,7,11,106,164
3979,Nagaland,2004,12. Total Crimes Against Women,0,5,50,0,78,0,55,0,20,45,80,108,30,50,78,0,0,158,13,0,36,75,97,62,23,75,0,110,110,185
3980,Odisha,2004,12. Total Crimes Against Women,3115,110,4724,23,482,258,4834,0,1440,1295,19589,18487,5239,4724,3597,2,2,23209,4861,49,7884,7691,859,469,662,30641,0,5720,28719,36410
3981,Puducherry,2004,12. Total Crimes Against Women,42,0,101,20,25,3,101,5,26,25,196,182,110,101,67,0,0,283,82,46,173,164,43,28,37,278,0,125,285,449
3982,Punjab,2004,12. Total Crimes Against Women,791,309,1460,60,466,263,1769,22,1103,1202,3681,3538,1955,1460,1257,0,0,4998,1818,153,3642,4031,1031,3491,2577,9925,525,2849,8896,12927
3983,Rajasthan,2004,12. Total Crimes Against Women,3378,225,8206,979,2480,4808,8431,0,717,829,29738,28369,13127,8206,5858,0,0,36575,6555,1670,14640,14639,4613,96,96,57341,1,11168,55540,70179
3984,Sikkim,2004,12. Total Crimes Against Women,4,6,25,6,4,0,31,0,33,15,20,9,49,25,8,0,0,34,6,8,69,40,2,19,38,44,10,8,20,60
3985,Tamil Nadu,2004,12. Total Crimes Against Women,2644,295,8514,133,4889,539,8809,76,1445,1539,10938,10090,9332,8514,7533,0,2,18604,5041,174,12750,12465,6032,2171,2268,17379,188,11073,16161,28626
3986,Tripura,2004,12. Total Crimes Against Women,272,83,568,0,85,15,651,0,304,300,1189,978,670,568,357,0,0,1546,328,76,983,890,136,337,197,1185,233,464,835,1725
3987,Uttar Pradesh,2004,12. Total Crimes Against Women,4467,1747,12186,1198,6518,1026,13933,0,1657,1131,42345,42342,15485,12186,10985,0,0,54528,10501,3621,32979,29866,13938,2338,3709,109619,1742,24439,107813,137679
3988,Uttarakhand,2004,12. Total Crimes Against Women,123,131,784,43,266,67,915,0,146,140,2000,1648,988,784,389,0,0,2432,329,69,2660,2116,689,259,420,5231,383,1018,4202,6318
3989,West Bengal,2004,12. Total Crimes Against Women,2442,840,9731,18,384,79,10571,3,6512,6118,50359,43472,11047,9731,2826,0,0,53203,6421,32,16613,14345,729,8883,9661,65287,1490,7150,58124,72469
3990,Andaman & Nicobar Islands,2005,12. Total Crimes Against Women,6,5,14,0,1,0,19,0,16,13,185,178,22,14,7,0,0,192,12,0,32,23,2,18,27,255,0,14,246,269
3991,Andhra Pradesh,2005,12. Total Crimes Against Women,8002,387,18226,3119,5353,2634,18613,0,5528,5958,24564,22812,20819,18226,13355,0,2,41038,14596,4976,31136,30369,7543,8899,8820,45330,846,22139,42076,72445
3992,Arunachal Pradesh,2005,12. Total Crimes Against Women,29,44,122,14,38,0,166,0,55,71,998,957,150,122,67,0,0,1079,30,14,129,105,45,85,59,1153,50,75,1137,1242
3993,Assam,2005,12. Total Crimes Against Women,2176,1369,3876,403,524,510,5245,1,6016,5745,10327,9554,6027,3876,2700,0,0,13430,3663,506,8760,5934,762,6422,6754,13584,2494,4425,12581,18515
3994,Bihar,2005,12. Total Crimes Against Women,2821,437,4267,68,626,384,4704,0,8063,7132,18962,18210,6019,4267,3447,0,0,22477,6178,183,11220,9280,1035,5725,6433,49978,1232,7213,48094,57374
3995,Chandigarh,2005,12. Total Crimes Against Women,45,9,141,0,12,28,150,0,75,48,515,431,205,141,57,0,0,572,80,0,306,247,17,66,98,989,27,97,839,1086
3996,Chhattisgarh,2005,12. Total Crimes Against Women,1841,74,3417,462,1085,10,3491,4,248,166,13296,13267,3599,3417,2926,0,12,16684,2789,1485,5491,5435,1683,40,88,18396,8,4472,18918,24353
3997,Dadra & Nagar Haveli,2005,12. Total Crimes Against Women,24,0,18,0,0,4,18,0,13,11,50,56,24,18,24,0,0,74,37,0,35,33,0,10,12,93,0,37,97,130
3998,Daman & Diu,2005,12. Total Crimes Against Women,4,1,8,0,0,0,9,0,4,3,25,21,10,8,4,0,0,29,7,0,17,18,0,2,1,54,0,7,43,61
3999,Delhi,2005,12. Total Crimes Against Women,1483,399,2552,0,473,178,2951,24,4368,3196,6521,5925,4351,2552,1956,0,26,8477,2631,0,5853,5238,798,2005,2439,20498,181,3429,18689,23927
4000,Goa,2005,12. Total Crimes Against Women,26,18,97,7,47,1,115,0,70,65,224,207,121,97,73,0,0,304,48,13,229,196,105,94,108,404,19,153,374,570
4001,Gujarat,2005,12. Total Crimes Against Women,2766,246,5834,331,345,131,6080,2,595,465,38148,35756,6343,5834,3111,0,0,41590,6275,820,16510,16314,555,713,906,97378,3,6830,88714,105028
4002,Haryana,2005,12. Total Crimes Against Women,1562,240,2914,10,741,853,3154,0,554,400,7773,7172,4161,2914,2303,0,0,10086,3800,54,6275,6264,1159,414,421,18421,4,4959,17170,23434
4003,Himachal Pradesh,2005,12. Total Crimes Against Women,633,13,668,138,73,106,681,0,163,157,2583,2759,793,668,706,0,0,3427,1087,233,1267,1242,102,188,194,4842,19,1189,5022,6264
4004,Jammu & Kashmir,2005,12. Total Crimes Against Women,996,35,1781,81,104,205,1816,0,715,592,7562,6962,2144,1781,1100,0,0,8743,1981,200,3163,3039,136,25,23,15296,126,2117,14574,17613
4005,Jharkhand,2005,12. Total Crimes Against Women,1620,268,1790,99,475,90,2058,0,2072,1676,6498,6907,2544,1790,2095,5,0,8692,4474,586,3432,2367,721,1910,2312,6170,663,5195,9584,11951
4006,Karnataka,2005,12. Total Crimes Against Women,3737,163,5102,429,1238,419,5265,78,1196,917,12349,12651,6057,5102,4975,0,16,17753,6965,644,10590,10335,2375,822,820,22205,257,9340,21854,32189
4007,Kerala,2005,12. Total Crimes Against Women,3104,111,5929,389,461,478,6040,0,2128,1884,22037,20062,6762,5929,3565,0,0,25991,5897,700,10669,10155,929,2204,2526,35217,192,6826,32588,42743
4008,Lakshadweep,2005,12. Total Crimes Against Women,0,0,1,0,0,0,1,0,0,1,4,3,0,1,0,0,0,4,0,0,0,0,0,1,1,2,0,0,2,2
4009,Madhya Pradesh,2005,12. Total Crimes Against Women,6985,196,13939,3746,3301,132,14135,0,867,605,47650,47746,14529,13939,10286,3,0,61682,12773,5518,24254,24298,5836,255,205,87051,6,18609,86880,111178
4010,Maharashtra,2005,12. Total Crimes Against Women,7648,243,12625,1162,616,172,12868,13,3283,2966,90721,87527,13370,12625,8264,5,0,100147,19642,2644,34156,33326,944,4320,5085,211852,65,20586,201756,235082
4011,Manipur,2005,12. Total Crimes Against Women,4,84,11,0,0,1,95,1,279,236,92,85,140,11,4,0,0,96,4,0,127,11,0,124,107,171,133,4,164,175
4012,Meghalaya,2005,12. Total Crimes Against Women,11,24,62,1,4,1,86,0,247,203,532,486,131,62,15,0,0,548,33,0,106,53,4,180,213,600,20,37,584,637
4013,Mizoram,2005,12. Total Crimes Against Women,11,2,89,11,29,0,91,0,30,26,160,122,95,89,40,0,0,211,4,0,85,70,169,80,95,49,0,173,152,222
4014,Nagaland,2005,12. Total Crimes Against Women,32,16,29,0,34,0,45,0,10,20,43,80,37,29,66,0,2,109,8,0,37,40,49,23,15,58,5,57,75,115
4015,Odisha,2005,12. Total Crimes Against Women,2557,93,5015,14,377,336,5108,3,2242,1440,21656,19589,6249,5015,2934,0,0,24604,4765,1,9524,9368,693,662,791,34550,27,5458,30641,40009
4016,Puducherry,2005,12. Total Crimes Against Women,29,0,109,26,36,2,109,1,41,26,214,196,127,109,65,0,0,305,45,40,191,177,54,37,51,315,0,99,277,454
4017,Punjab,2005,12. Total Crimes Against Women,687,230,1381,31,224,271,1611,13,1177,1103,4120,3681,1969,1381,911,0,0,5062,1498,157,3303,3027,498,2577,2571,10799,282,1996,9925,12952
4018,Rajasthan,2005,12. Total Crimes Against Women,3052,273,7393,1281,2383,4194,7666,0,514,717,30415,29738,11657,7393,5435,0,0,37131,5492,2200,12838,12856,4042,96,74,58463,4,9534,57341,70197
4019,Sikkim,2005,12. Total Crimes Against Women,10,10,26,10,6,0,36,0,59,33,20,20,62,26,16,0,0,46,10,10,42,25,5,38,21,44,34,15,44,69
4020,Tamil Nadu,2005,12. Total Crimes Against Women,3458,266,7877,64,4630,678,8143,31,1241,1445,10655,10938,8648,7877,8088,8,0,18807,5727,39,12275,12471,6152,2268,1797,17888,275,11879,17335,29806
4021,Tripura,2005,12. Total Crimes Against Women,415,124,742,0,111,4,866,0,274,304,1405,1189,840,742,526,0,0,1931,815,8,1308,1090,192,197,358,1260,57,1007,1185,2275
4022,Uttar Pradesh,2005,12. Total Crimes Against Women,4418,1619,12316,981,6484,908,13935,0,1689,1657,42778,42345,14875,12316,10902,0,0,54661,10973,3024,32720,31006,14537,3709,4103,112091,1320,25510,109619,140625
4023,Uttarakhand,2005,12. Total Crimes Against Women,195,111,603,67,183,56,714,0,162,146,2158,2000,786,603,378,0,0,2603,359,68,1648,1465,382,420,374,5887,229,741,5231,6696
4024,West Bengal,2005,12. Total Crimes Against Women,3680,582,11199,34,812,48,11781,4,6566,6512,57032,50359,11887,11199,4492,0,0,61558,7734,60,19227,17324,1261,9661,9949,73556,1615,8995,65287,82611
4025,Andaman & Nicobar Islands,2006,12. Total Crimes Against Women,7,5,39,0,1,0,44,0,8,16,216,185,36,39,8,0,0,224,7,0,49,63,1,27,13,310,0,8,255,318
4026,Andhra Pradesh,2006,12. Total Crimes Against Women,7242,398,16139,3422,3579,2560,16537,1,7914,5528,26458,24564,21484,16139,10821,2,0,40701,17063,6559,30660,27617,5892,8820,10782,43433,1081,22955,45330,72947
4027,Arunachal Pradesh,2006,12. Total Crimes Against Women,23,29,108,10,16,0,137,0,86,55,1057,998,168,108,39,0,0,1106,26,11,141,114,22,59,61,1208,25,48,1153,1267
4028,Assam,2006,12. Total Crimes Against Women,2400,1458,3987,310,692,597,5445,1,6774,6016,10912,10327,6801,3987,3092,0,0,14314,3718,488,8438,5425,955,6754,7058,13848,2709,4673,13584,19009
4029,Bihar,2006,12. Total Crimes Against Women,3225,891,4488,287,801,550,5379,0,8874,8063,19137,18962,6740,4488,4026,0,0,23450,7117,591,11757,9827,1591,6433,7354,50506,1009,8708,49978,59805
4030,Chandigarh,2006,12. Total Crimes Against Women,66,28,133,0,24,42,161,0,96,75,558,515,224,133,90,0,0,648,118,0,352,267,33,98,103,1105,80,151,989,1256
4031,Chhattisgarh,2006,12. Total Crimes Against Women,1201,65,3665,395,881,13,3730,2,260,248,14484,13296,3757,3665,2082,0,0,16961,2434,543,5758,5676,1491,88,170,19604,0,3925,18396,24072
4032,Dadra & Nagar Haveli,2006,12. Total Crimes Against Women,9,2,22,0,2,4,24,0,17,13,61,50,32,22,11,0,0,72,19,0,25,31,3,12,6,102,0,22,93,124
4033,Daman & Diu,2006,12. Total Crimes Against Women,5,0,9,0,1,0,9,0,4,4,28,25,9,9,6,0,0,34,15,0,28,26,3,1,3,62,0,18,54,80
4034,Delhi,2006,12. Total Crimes Against Women,1263,357,2909,0,565,171,3266,31,5413,4368,7602,6521,4544,2909,1828,0,31,9430,1291,0,6207,5537,925,2439,2891,23819,218,2216,20498,26035
4035,Goa,2006,12. Total Crimes Against Women,28,21,83,6,29,1,104,0,61,70,244,224,96,83,57,0,0,307,42,6,159,166,65,108,73,457,28,107,404,570
4036,Gujarat,2006,12. Total Crimes Against Women,2631,211,6592,363,276,136,6803,12,923,595,41470,38148,7279,6592,2907,0,0,44740,6524,1173,18188,17566,543,906,1524,106704,4,7067,97378,114944
4037,Haryana,2006,12. Total Crimes Against Women,1385,209,3255,19,791,939,3464,0,768,554,8833,7773,4617,3255,2176,0,0,11028,3157,56,6857,6665,1308,421,613,20565,0,4465,18421,25086
4038,Himachal Pradesh,2006,12. Total Crimes Against Women,378,14,645,123,69,113,659,0,183,163,2658,2583,792,645,447,0,0,3228,624,248,1151,1153,97,194,165,5026,27,721,4842,5995
4039,Jammu & Kashmir,2006,12. Total Crimes Against Women,1029,28,2142,136,170,229,2170,0,748,715,8369,7562,2432,2142,1199,0,0,9704,1867,274,3896,3887,268,23,13,16774,19,2135,15296,19183
4040,Jharkhand,2006,12. Total Crimes Against Women,1906,230,2110,72,629,92,2340,0,2619,2072,5998,6498,2979,2110,2535,3,0,8605,1990,506,4117,3733,526,2312,2576,6881,120,2516,6170,9903
4041,Karnataka,2006,12. Total Crimes Against Women,3792,174,5252,571,716,444,5426,70,1316,1196,12522,12349,6084,5252,4508,0,24,17601,7426,707,11035,10494,1509,820,1139,23057,222,8935,22205,32699
4042,Kerala,2006,12. Total Crimes Against Women,3769,171,6565,460,617,567,6736,0,2378,2128,23756,22037,7554,6565,4386,0,1,28602,7950,549,11406,10926,1159,2526,2958,36485,48,9109,35217,46143
4043,Lakshadweep,2006,12. Total Crimes Against Women,0,0,0,0,0,0,0,0,1,0,3,3,1,0,0,0,0,3,0,0,1,0,0,0,1,2,0,0,2,2
4044,Madhya Pradesh,2006,12. Total Crimes Against Women,5835,187,13950,3327,3705,129,14137,0,922,867,48733,47650,14321,13950,9540,0,0,61600,10005,4734,23753,23696,6061,205,259,89947,3,16066,87051,110747
4045,Maharashtra,2006,12. Total Crimes Against Women,6670,264,13020,1042,584,311,13284,1,4139,3283,95444,90721,14452,13020,7254,1,0,103740,17028,2007,36197,34067,1064,5085,7103,225820,112,18092,211852,245919
4046,Manipur,2006,12. Total Crimes Against Women,1,103,3,1,3,0,106,0,344,279,90,92,171,3,4,0,0,95,2,0,104,3,2,107,154,170,54,4,171,174
4047,Meghalaya,2006,12. Total Crimes Against Women,27,53,88,2,7,1,141,0,281,247,584,532,176,88,34,0,0,620,32,2,158,101,10,212,245,657,24,42,600,701
4048,Mizoram,2006,12. Total Crimes Against Women,12,10,128,2,209,0,138,0,17,30,65,160,125,128,221,0,0,288,15,0,138,139,128,95,94,45,0,143,49,188
4049,Nagaland,2006,12. Total Crimes Against Women,1,0,36,1,26,0,36,0,17,10,51,43,43,36,27,0,0,79,7,1,64,52,38,15,22,64,5,45,58,110
4050,Odisha,2006,12. Total Crimes Against Women,2770,145,5851,0,535,338,5996,2,2731,2242,24202,21656,6825,5851,3305,0,0,27507,4660,0,10408,10179,957,791,1008,39112,12,5617,34550,44729
4051,Puducherry,2006,12. Total Crimes Against Women,27,0,139,9,35,2,139,3,46,41,282,214,149,139,62,0,0,353,39,14,260,250,77,51,61,435,0,116,315,565
4052,Punjab,2006,12. Total Crimes Against Women,734,246,1588,12,276,250,1834,18,1317,1177,4686,4120,2242,1588,1010,0,0,5708,1748,35,3882,3094,697,2571,3106,11413,253,2445,10799,13893
4053,Rajasthan,2006,12. Total Crimes Against Women,3458,292,8155,1317,2719,4535,8447,1,465,514,30956,30415,12934,8155,6177,120,0,38450,6405,2500,14546,14565,4987,74,53,59136,2,11392,58463,73028
4054,Sikkim,2006,12. Total Crimes Against Women,4,1,34,8,3,0,35,0,71,59,39,20,47,34,7,0,0,54,4,8,39,34,3,21,12,63,14,7,44,78
4055,Tamil Nadu,2006,12. Total Crimes Against Women,2979,267,5598,35,2923,402,5865,48,1397,1241,10316,10655,6489,5598,5902,0,18,16253,5679,29,9483,8987,4991,1797,2032,16176,261,10670,17888,26875
4056,Tripura,2006,12. Total Crimes Against Women,351,134,834,0,106,2,968,0,268,274,1782,1405,964,834,457,0,0,2239,660,7,1272,892,159,358,275,1326,463,819,1260,2152
4057,Uttar Pradesh,2006,12. Total Crimes Against Women,4788,1989,13254,879,6800,1014,15243,0,1807,1689,43565,42778,16375,13254,11588,0,0,56032,11354,2499,34720,32599,15710,4103,3979,115127,2245,27064,112091,144690
4058,Uttarakhand,2006,12. Total Crimes Against Women,207,141,836,227,207,61,977,0,162,162,2353,2158,1038,836,414,0,0,2994,543,406,2176,1895,523,374,437,6310,218,1066,5887,7782
4059,West Bengal,2006,12. Total Crimes Against Women,5544,1113,11445,83,1001,93,12558,5,6695,6566,61849,57032,12785,11445,6545,0,0,68477,8721,164,22398,18226,2077,9949,12225,80820,1896,10798,73556,91782
4060,Andaman & Nicobar Islands,2007,12. Total Crimes Against Women,8,5,36,0,3,0,41,0,23,8,241,216,56,36,11,0,0,252,21,0,80,50,6,13,43,333,0,27,310,360
4061,Andhra Pradesh,2007,12. Total Crimes Against Women,9470,572,20967,4612,3911,3470,21539,2,7641,7914,29430,26458,24738,20967,13381,2,0,47423,17713,5305,35121,34088,6093,10782,10937,48410,878,23806,43433,77521
4062,Arunachal Pradesh,2007,12. Total Crimes Against Women,17,55,128,4,16,0,183,0,88,86,1148,1057,185,128,33,0,0,1185,20,3,203,155,20,61,50,1320,59,40,1208,1363
4063,Assam,2007,12. Total Crimes Against Women,2787,1287,4148,250,821,813,5435,0,7370,6774,11202,10912,6844,4148,3608,0,0,15060,4312,416,8797,5755,851,7058,7587,14024,2513,5163,13848,19603
4064,Bihar,2007,12. Total Crimes Against Women,3330,985,5941,302,764,945,6926,0,8551,8874,20682,19137,7548,5941,4094,0,0,25078,7955,652,14955,11842,1425,7354,9559,52316,908,9380,50506,62348
4065,Chandigarh,2007,12. Total Crimes Against Women,71,25,128,0,28,36,153,0,137,96,587,558,230,128,99,0,0,686,126,0,290,232,40,103,125,1171,36,166,1105,1337
4066,Chhattisgarh,2007,12. Total Crimes Against Women,1404,55,3637,448,580,40,3692,0,303,260,15689,14484,3775,3637,1984,0,0,18121,2183,937,5855,5764,1038,170,258,21210,3,3221,19604,25368
4067,Dadra & Nagar Haveli,2007,12. Total Crimes Against Women,12,4,14,0,1,1,18,0,16,17,62,61,18,14,13,0,0,75,14,0,21,17,1,6,10,104,0,15,102,119
4068,Daman & Diu,2007,12. Total Crimes Against Women,4,0,7,0,1,0,7,0,8,4,30,28,11,7,5,0,0,35,8,0,57,30,1,3,28,83,2,9,62,92
4069,Delhi,2007,12. Total Crimes Against Women,1275,400,2587,0,646,224,2987,36,6950,5413,8268,7602,4804,2587,1921,0,20,10189,1368,0,5648,4739,1022,2891,3632,26168,168,2390,23819,28558
4070,Goa,2007,12. Total Crimes Against Women,26,9,48,6,10,1,57,0,83,61,250,244,80,48,36,0,0,292,58,13,145,88,14,73,121,460,9,72,457,545
4071,Gujarat,2007,12. Total Crimes Against Women,2869,266,7763,337,298,132,8029,16,1005,923,45729,41470,8260,7763,3167,0,1,49233,7335,1031,21665,21625,581,1524,1558,119382,6,7916,106704,128329
4072,Haryana,2007,12. Total Crimes Against Women,1598,232,3368,31,636,968,3600,0,845,768,9936,8833,4645,3368,2234,0,0,12201,3760,83,7071,6876,1111,613,808,22487,0,4871,20565,27441
4073,Himachal Pradesh,2007,12. Total Crimes Against Women,414,19,727,181,53,149,746,0,306,183,2737,2658,1018,727,467,0,0,3385,705,282,1476,1302,76,165,323,5265,16,781,5026,6328
4074,Jammu & Kashmir,2007,12. Total Crimes Against Women,936,80,2192,116,123,336,2272,0,661,748,9386,8369,2521,2192,1059,0,0,10561,1894,216,4411,4398,183,13,12,18879,14,2077,16774,21172
4075,Jharkhand,2007,12. Total Crimes Against Women,1850,335,2383,72,829,177,2718,2,3039,2619,5630,5998,3317,2383,2679,0,0,8381,3095,132,4528,4047,854,2576,2778,6847,279,3949,6881,10928
4076,Karnataka,2007,12. Total Crimes Against Women,3574,302,5576,339,685,607,5878,89,1306,1316,13499,12522,6569,5576,4259,1,5,18097,7084,609,11302,11049,1412,1139,1154,25001,238,8496,23057,34106
4077,Kerala,2007,12. Total Crimes Against Women,4568,185,7267,575,470,500,7452,0,2263,2378,25410,23756,7837,7267,5038,0,0,31023,8297,752,11210,11440,805,2958,2718,38071,10,9102,36485,47925
4078,Lakshadweep,2007,12. Total Crimes Against Women,0,0,2,0,0,0,2,0,4,1,5,3,5,2,0,0,0,5,0,0,2,2,0,1,1,4,0,0,2,4
4079,Madhya Pradesh,2007,12. Total Crimes Against Women,6468,230,15030,3540,3737,118,15260,0,914,922,50018,48733,15370,15030,10205,0,0,63763,11806,5799,25990,25989,6932,259,260,91399,0,18738,89947,115936
4080,Maharashtra,2007,12. Total Crimes Against Women,6760,304,13516,962,597,389,13820,2,4852,4139,100641,95444,14924,13516,7357,0,0,108960,17920,2044,36040,34625,1073,7103,8398,239408,120,18993,225820,260445
4081,Manipur,2007,12. Total Crimes Against Women,7,86,3,1,1,0,89,0,443,344,84,90,188,3,8,0,0,93,10,1,133,3,1,154,151,161,133,11,170,173
4082,Meghalaya,2007,12. Total Crimes Against Women,14,22,67,2,16,1,89,0,363,281,619,584,172,67,30,0,0,651,22,2,130,71,30,245,268,674,36,52,657,728
4083,Mizoram,2007,12. Total Crimes Against Women,10,8,142,0,84,0,150,0,18,17,113,65,151,142,94,0,0,207,7,0,152,163,95,94,83,106,0,102,45,208
4084,Nagaland,2007,12. Total Crimes Against Women,2,3,25,1,38,0,28,0,21,17,35,51,32,25,40,0,0,76,2,6,58,40,49,22,21,47,19,51,64,104
4085,Odisha,2007,12. Total Crimes Against Women,2630,148,6098,3,547,270,6246,2,3517,2731,27120,24202,7304,6098,3177,0,0,30300,5023,0,10424,9902,1391,1008,1501,42600,29,6414,39112,49014
4086,Puducherry,2007,12. Total Crimes Against Women,48,2,178,20,32,5,180,7,33,46,360,282,179,178,80,0,0,460,96,29,337,351,69,61,44,592,3,165,435,786
4087,Punjab,2007,12. Total Crimes Against Women,728,355,1672,12,274,314,2027,0,1670,1317,5344,4686,2694,1672,1002,0,0,6358,2109,31,4211,3358,708,3106,3593,11923,366,2817,11413,14771
4088,Rajasthan,2007,12. Total Crimes Against Women,3080,261,8693,1145,2446,5249,8954,1,531,465,32968,30956,14270,8693,5526,10,0,39639,5280,2079,14548,14528,4138,53,73,62167,0,9418,59136,73664
4089,Sikkim,2007,12. Total Crimes Against Women,9,2,33,4,2,0,35,0,91,71,57,39,55,33,11,0,0,72,9,3,63,44,2,12,20,93,11,11,63,107
4090,Tamil Nadu,2007,12. Total Crimes Against Women,2982,369,5963,16,2116,602,6332,45,2224,1397,11165,10316,7811,5963,5098,0,5,16279,5487,28,11601,10449,3338,2032,2886,17772,298,8825,16176,26625
4091,Tripura,2007,12. Total Crimes Against Women,690,77,1078,0,133,0,1155,0,180,268,2037,1782,1067,1078,823,0,0,2860,866,79,1107,1175,222,275,142,1334,65,1088,1326,2501
4092,Uttar Pradesh,2007,12. Total Crimes Against Women,5317,3376,15626,1022,6918,1882,19002,0,1916,1807,45934,43565,20993,15626,12235,0,0,59191,15579,2603,48291,39978,17392,3979,5081,119531,7211,32971,115127,155105
4093,Uttarakhand,2007,12. Total Crimes Against Women,250,160,810,213,329,94,970,0,195,162,2371,2353,1097,810,579,0,0,3163,518,488,2711,2059,804,437,620,6559,469,1322,6310,8369
4094,West Bengal,2007,12. Total Crimes Against Women,4489,738,14424,74,467,45,15162,2,8030,6695,71243,61849,16544,14424,4956,0,0,76273,10742,382,22175,22423,667,12225,10996,91452,981,11409,80820,103243
4095,Andaman & Nicobar Islands,2009,12. Total Crimes Against Women,13,19,64,0,2,0,83,0,45,36,333,284,92,64,15,0,0,348,19,0,126,108,2,40,58,494,0,21,407,515
4096,Andhra Pradesh,2009,12. Total Crimes Against Women,11123,888,20907,5167,2668,2936,21795,1,8643,7806,34981,33035,25569,20907,13791,3,0,53939,19995,8541,36465,34101,4118,10305,11613,56249,1056,24113,54802,88903
4097,Arunachal Pradesh,2009,12. Total Crimes Against Women,20,33,147,4,25,0,180,0,67,83,1323,1225,164,147,45,0,0,1372,23,4,182,158,25,51,52,1514,23,48,1408,1566
4098,Assam,2009,12. Total Crimes Against Women,2273,2014,5324,354,622,739,7338,29,10043,8428,15182,13107,9721,5324,2895,0,0,18431,3194,344,11810,6435,892,7933,9270,16411,4038,4086,14406,20841
4099,Bihar,2009,12. Total Crimes Against Women,3434,1702,5423,352,788,991,7125,0,9913,9226,22868,22019,8803,5423,4222,0,0,27442,8432,863,14457,12000,1822,11129,13270,55299,316,10254,54416,66416
4100,Chandigarh,2009,12. Total Crimes Against Women,74,5,64,0,43,53,69,0,162,134,534,587,150,64,117,0,0,651,137,0,158,148,69,164,135,1076,39,206,1134,1282
4101,Chhattisgarh,2009,12. Total Crimes Against Women,1867,51,3928,325,669,61,3979,0,320,358,17361,16600,4002,3928,2536,306,0,20222,2703,540,6337,6259,866,349,406,25208,21,3569,23058,29317
4102,Dadra & Nagar Haveli,2009,12. Total Crimes Against Women,4,0,18,0,3,1,18,0,19,18,85,74,20,18,7,0,0,92,8,0,20,34,4,20,6,163,0,12,141,175
4103,Daman & Diu,2009,12. Total Crimes Against Women,5,2,7,0,0,0,9,0,15,11,32,30,13,7,5,0,0,37,20,0,38,17,0,10,31,132,0,20,135,152
4104,Delhi,2009,12. Total Crimes Against Women,818,792,2569,0,623,417,3361,48,7250,6924,10809,9681,4251,2569,1441,0,99,12250,1302,0,2753,3339,800,1893,1218,28783,89,2102,27546,30885
4105,Goa,2009,12. Total Crimes Against Women,66,29,97,0,20,3,126,0,146,111,279,268,164,97,86,0,0,365,96,0,235,158,27,142,190,502,29,123,467,625
4106,Gujarat,2009,12. Total Crimes Against Women,3873,293,7449,259,236,93,7742,18,1166,1010,52602,49522,8009,7449,4109,1,0,56970,10373,1074,21170,21336,825,1487,1320,139149,1,11198,130085,151421
4107,Haryana,2009,12. Total Crimes Against Women,2141,240,3726,21,851,1168,3966,0,1056,878,11430,10717,5312,3726,2992,0,0,14443,4530,88,7350,7371,1403,831,806,25387,4,5933,24037,31408
4108,Himachal Pradesh,2009,12. Total Crimes Against Women,419,15,899,101,65,145,914,0,211,316,3281,2967,954,899,484,0,0,3866,750,222,1428,1527,122,340,226,6167,15,872,5734,7261
4109,Jammu & Kashmir,2009,12. Total Crimes Against Women,1172,40,2125,196,207,548,2165,0,873,962,10454,9904,2624,2125,1379,0,0,12029,1946,414,4095,4086,362,12,21,21425,0,2308,20061,24147
4110,Jharkhand,2009,12. Total Crimes Against Women,1690,395,2797,190,1076,154,3192,0,2761,3086,5520,5679,3021,2797,2766,0,0,8476,2486,186,4309,4205,1645,3068,3111,7700,61,4131,7812,12017
4111,Karnataka,2009,12. Total Crimes Against Women,3636,262,6387,637,368,520,6649,105,2011,1451,16584,14838,7852,6387,4004,0,18,21225,8937,1091,13941,13432,833,1781,1950,30150,340,9770,27579,41011
4112,Kerala,2009,12. Total Crimes Against Women,4175,230,7759,486,664,383,7989,2,2072,2397,29859,27425,8049,7759,4839,0,0,35184,7288,800,11132,11694,1068,2649,2080,43093,7,8356,40555,52249
4113,Lakshadweep,2009,12. Total Crimes Against Women,2,2,3,0,0,0,5,0,1,5,6,5,1,3,2,0,0,8,2,0,2,3,0,2,1,5,0,2,4,7
4114,Madhya Pradesh,2009,12. Total Crimes Against Women,6916,173,15887,3772,3657,73,16060,0,800,1106,50565,49023,15827,15887,10573,0,0,64910,12695,6137,28262,28193,6430,323,387,91596,5,19125,88665,116858
4115,Maharashtra,2009,12. Total Crimes Against Women,7469,351,14393,1144,636,332,14744,3,5193,5224,110593,105449,15048,14393,8105,0,0,119842,20536,2532,41095,39858,1116,9633,10754,266808,116,21652,251134,290992
4116,Manipur,2009,12. Total Crimes Against Women,0,62,8,0,0,0,70,0,721,597,98,90,194,8,0,0,0,98,0,0,183,10,0,114,184,176,103,0,166,176
4117,Meghalaya,2009,12. Total Crimes Against Women,44,66,130,0,12,0,196,0,512,471,705,631,237,130,56,0,0,761,46,1,178,190,12,317,281,824,24,58,693,883
4118,Mizoram,2009,12. Total Crimes Against Women,16,3,160,0,117,0,163,0,18,31,147,120,150,160,133,0,0,280,29,0,165,235,123,101,31,196,0,152,113,348
4119,Nagaland,2009,12. Total Crimes Against Women,2,5,49,0,26,0,54,0,15,23,63,42,46,49,28,0,0,91,2,0,72,62,54,23,14,61,19,56,55,117
4120,Odisha,2009,12. Total Crimes Against Women,3052,83,6576,0,486,327,6659,3,5874,4743,32700,29662,8120,6576,3538,0,0,36238,6004,0,11346,11142,742,1651,1855,50195,0,6746,45799,56941
4121,Puducherry,2009,12. Total Crimes Against Women,50,1,119,8,19,9,120,5,15,43,459,417,106,119,69,0,0,536,129,20,152,176,47,41,16,679,1,176,699,875
4122,Punjab,2009,12. Total Crimes Against Women,1099,356,1849,9,565,402,2205,0,1685,1661,6084,5908,2631,1849,1664,0,0,7757,2118,13,4100,3428,1034,3556,3899,13392,329,3152,13129,16557
4123,Rajasthan,2009,12. Total Crimes Against Women,2813,527,10092,1019,2408,6617,10619,0,764,684,39197,35345,17316,10092,5221,0,0,45437,5008,1985,15455,15460,4006,90,85,69425,0,9014,64964,80424
4124,Sikkim,2009,12. Total Crimes Against Women,16,26,63,15,19,0,89,0,37,85,102,89,41,63,35,0,0,152,27,36,76,66,25,18,24,96,4,52,118,184
4125,Tamil Nadu,2009,12. Total Crimes Against Women,2822,575,4858,19,1596,644,5433,0,2292,2318,12363,11942,6051,4858,4418,0,0,16800,5508,5,9450,9499,2977,3678,3407,20814,222,8485,19805,29304
4126,Tripura,2009,12. Total Crimes Against Women,556,98,1406,45,87,0,1504,0,214,201,3459,2741,1517,1406,643,0,0,4147,1114,460,2727,1910,121,84,408,2193,493,1235,1978,3888
4127,Uttar Pradesh,2009,12. Total Crimes Against Women,6391,3479,17364,1060,8555,2181,20843,0,2236,2006,48666,47308,23254,17364,14946,0,0,64672,18524,3404,63332,47745,23471,6117,6897,125133,14807,41995,122787,170532
4128,Uttarakhand,2009,12. Total Crimes Against Women,221,182,999,46,397,61,1181,0,134,188,2957,2622,1188,999,618,0,0,3621,603,70,2064,1963,974,200,241,6286,60,1577,5970,7933
4129,West Bengal,2009,12. Total Crimes Against Women,4362,988,18648,65,467,86,19636,6,16529,12950,94909,81155,23307,18648,4829,0,0,99803,11066,608,20671,19766,651,12419,12367,109399,957,11717,101958,121724
4130,Andaman & Nicobar Islands,2010,12. Total Crimes Against Women,5,12,68,0,0,0,80,0,50,45,396,333,85,68,5,0,0,401,7,0,131,112,0,58,77,599,0,7,494,606
4131,Andhra Pradesh,2010,12. Total Crimes Against Women,11606,1502,23851,4990,3166,2911,25353,23,7600,8643,39066,34981,27244,23851,14772,4,0,58828,19925,8096,38570,39417,4472,11613,9913,63173,853,24397,56249,95666
4132,Arunachal Pradesh,2010,12. Total Crimes Against Women,10,33,117,8,11,0,150,0,107,67,1411,1323,190,117,21,0,0,1440,12,10,197,138,12,52,81,1618,30,24,1514,1652
4133,Assam,2010,12. Total Crimes Against Women,2681,2252,6293,205,522,879,8545,115,12059,10043,18067,15182,11555,6293,3203,0,0,21475,3912,487,12996,7496,833,9270,10523,18675,4247,4745,16411,23907
4134,Bihar,2010,12. Total Crimes Against Women,3340,1230,5281,381,861,899,6511,0,10974,9913,23567,22868,8471,5281,4201,0,0,28149,7694,902,13134,12422,1554,13270,13391,57571,591,9248,55299,67721
4135,Chandigarh,2010,12. Total Crimes Against Women,127,24,90,0,44,71,114,0,118,162,453,534,141,90,171,0,0,624,183,0,138,124,57,135,80,960,69,240,1076,1200
4136,Chhattisgarh,2010,12. Total Crimes Against Women,2293,86,3917,404,860,41,4003,0,452,320,17721,17361,4176,3917,3153,0,0,21278,3467,638,6577,6481,1343,406,410,26241,92,4810,25208,31689
4137,Dadra & Nagar Haveli,2010,12. Total Crimes Against Women,4,0,17,0,6,3,17,0,29,19,92,85,30,17,10,0,0,102,4,0,46,31,8,6,21,182,0,12,163,194
4138,Daman & Diu,2010,12. Total Crimes Against Women,6,1,11,1,0,0,12,0,17,15,36,32,14,11,6,0,0,43,12,1,51,42,0,31,40,164,0,12,135,177
4139,Delhi,2010,12. Total Crimes Against Women,1161,746,2428,0,586,598,3174,30,7853,7250,11490,10809,4518,2428,1747,0,113,13237,1835,0,3040,2852,997,1218,1315,28803,91,2832,28783,31635
4140,Goa,2010,12. Total Crimes Against Women,65,22,127,0,13,8,149,0,129,146,328,279,140,127,78,0,0,406,98,0,214,217,16,190,158,605,29,114,502,719
4141,Gujarat,2010,12. Total Crimes Against Women,4105,345,7690,237,228,71,8035,13,1194,1166,55722,52602,8148,7690,4333,0,1,60292,10896,510,20459,20277,974,1320,1500,147046,2,11870,139149,159426
4142,Haryana,2010,12. Total Crimes Against Women,2411,248,3960,23,903,1181,4208,0,1229,1056,12053,11430,5562,3960,3314,0,0,15390,5601,62,7540,7232,1712,806,1113,25244,1,7313,25387,32619
4143,Himachal Pradesh,2010,12. Total Crimes Against Women,335,18,817,101,51,166,835,0,238,211,3611,3281,1028,817,386,0,0,4098,698,201,1481,1464,97,226,242,6635,1,795,6167,7631
4144,Jammu & Kashmir,2010,12. Total Crimes Against Women,870,49,1813,190,145,588,1862,0,1034,873,11062,10454,2611,1813,1015,0,0,12267,1562,454,3569,3544,215,21,46,22738,0,1777,21425,24969
4145,Jharkhand,2010,12. Total Crimes Against Women,1887,396,2607,70,618,198,3003,0,2647,2761,5552,5520,3087,2607,2505,0,0,8127,3619,93,5172,6031,1156,3111,2222,8863,30,4775,7700,13731
4146,Karnataka,2010,12. Total Crimes Against Women,3910,491,7282,259,511,728,7773,63,2219,2011,19167,16584,8807,7282,4421,19,35,23847,8921,1244,15179,13880,868,1950,2422,32997,827,9789,30150,44030
4147,Kerala,2010,12. Total Crimes Against Women,4160,137,8871,297,637,391,9008,7,2129,2072,33636,29859,9463,8871,4797,0,0,38730,7154,484,13253,13471,886,2080,1860,48040,2,8040,43093,56564
4148,Lakshadweep,2010,12. Total Crimes Against Women,0,0,1,0,0,0,1,0,1,1,7,6,1,1,0,0,0,7,0,0,1,1,0,1,1,6,0,0,5,6
4149,Madhya Pradesh,2010,12. Total Crimes Against Women,7540,186,16083,3638,4177,72,16269,0,927,800,51291,50565,16468,16083,11717,2,0,66646,13649,5691,27814,27837,7525,387,309,92568,55,21174,91596,119433
4150,Maharashtra,2010,12. Total Crimes Against Women,8990,330,14661,1107,565,289,14991,10,5639,5193,114591,110593,15737,14661,9555,1,1,125253,24476,2381,40377,39236,1073,10754,11771,278114,124,25549,266808,306044
4151,Manipur,2010,12. Total Crimes Against Women,4,66,6,0,1,0,72,0,839,721,99,98,190,6,5,0,0,104,8,0,141,7,1,184,229,174,89,9,176,183
4152,Meghalaya,2010,12. Total Crimes Against Women,23,17,133,9,7,1,150,0,622,512,799,705,261,133,30,0,0,838,30,8,228,130,8,281,349,908,30,38,824,954
4153,Mizoram,2010,12. Total Crimes Against Women,10,0,171,0,159,0,171,0,17,18,149,147,170,171,169,0,0,318,15,0,194,210,250,31,15,141,0,265,196,406
4154,Nagaland,2010,12. Total Crimes Against Women,16,5,39,0,33,0,44,0,12,15,53,63,41,39,49,0,0,102,14,2,66,54,18,14,12,81,14,32,61,115
4155,Odisha,2010,12. Total Crimes Against Women,4341,143,8635,0,485,448,8778,8,5141,5874,36509,32700,8501,8635,4826,0,0,41335,8330,0,16112,16298,932,1855,1592,57231,77,9262,50195,66493
4156,Puducherry,2010,12. Total Crimes Against Women,48,1,109,12,21,8,110,1,11,15,487,459,115,109,69,0,0,568,103,16,205,203,48,16,15,715,3,151,679,882
4157,Punjab,2010,12. Total Crimes Against Women,1082,450,1932,13,497,510,2382,0,1572,1611,5970,5630,2853,1932,1579,0,0,7562,2305,14,4646,4367,1084,3617,3519,13195,377,3389,12231,16598
4158,Rajasthan,2010,12. Total Crimes Against Women,2753,391,10232,1159,2072,7358,10623,1,964,764,43445,39197,18182,10232,4825,0,0,49429,4760,1841,15335,15321,3720,85,98,74425,1,8480,69425,84746
4159,Sikkim,2010,12. Total Crimes Against Women,6,3,58,3,6,0,61,0,18,37,145,102,42,58,12,0,0,160,11,3,68,57,5,24,23,134,12,16,96,153
4160,Tamil Nadu,2010,12. Total Crimes Against Women,2823,565,4780,13,1749,708,5345,0,2947,2292,12558,12363,6708,4780,4572,0,0,17143,5583,4,9649,8841,2809,3407,4038,21259,177,8392,20814,29655
4161,Tripura,2010,12. Total Crimes Against Women,683,102,1360,74,95,15,1462,0,415,214,3967,3459,1678,1360,778,0,0,4819,1323,154,2127,1611,144,408,584,2183,340,1467,2193,3804
4162,Uttar Pradesh,2010,12. Total Crimes Against Women,6976,3746,14401,366,10307,1704,18147,0,2554,2236,45418,48666,20169,14401,17283,0,0,63067,20826,1469,58330,41235,27706,6897,7934,116367,16058,48532,125133,166368
4163,Uttarakhand,2010,12. Total Crimes Against Women,308,185,864,17,499,47,1049,0,112,134,2997,2957,1074,864,807,0,0,3821,1052,78,1750,1683,1075,241,231,5764,77,2127,6286,7969
4164,West Bengal,2010,12. Total Crimes Against Women,4084,1110,23528,125,435,120,24638,4,17892,16529,113793,94909,26125,23528,4519,0,0,118437,11372,670,26549,28005,628,12367,9661,124734,1250,12000,109399,137404
